ابتدا	ابتدا	Dg
ابتدای	ابتدا	Ncs
ابتدایی	ابتدایی	As
ابتکار	ابتکار	Ncs
ابتلا	ابتلا	Ncs
ابرار	بر	Nal
ابراز	ابراز	Ncs
ابراهیم	ابراهیم	Nas
ابزارخورده	ابزارخورده	As
ابزاری	ابزار	Ncs
ابطال	ابطال	Ncs
ابطحی	ابطحی	Nas
ابعاد	بعد	Ncl
ابوالحسن	ابوالحسن	Nas
ابوچی	ابوچی	Nas
ابوسفیان	ابوسفیان	Nas
ابوعماره	ابوعماره	Nas
ابهامات	ابهام	Ncl
اپرا	اپرا	Ncs
اپوزیسیون	اپوزیسیون	Ncs
اتاق	اتاق	Ncs
اتحادیه	اتحادیه	Ncs
اتخاذ	اتخاذ	Ncs
اتفاق	اتفاق	Ncs
اتفاقا	اتفاقا	Dg
اتفاقات	اتفاق	Ncl
اتل	اتل	Nas
اتمام	اتمام	Ncs
اتهام	اتهام	Ncs
اتهامات	اتهام	Ncl
اثبات	اثبات	Ncs
اثر	اثر	Ncs
اثرات	اثر	Ncl
اثرگذار	اثرگذار	As
اجازه	اجازه	Ncs
اجتماع	اجتماع	Ncs
اجتماعی	اجتماعی	As
اجتناب	اجتناب	Ncs
اجر	اجر	Ncs
اجرا	اجرا	Ncs
اجرای	اجرا	Ncs
اجرایی	اجرایی	As
اجرت	اجرت	Ncs
اجزای	جزء	Ncl
احادیث	حدیث	Ncl
احادیثی	حدیث	Ncl
احترام	احترام	Ncs
احتمال	احتمال	Ncs
احتمالا	احتمالا	Dg
احتمالی	احتمالی	As
احتیاج	احتیاج	Ncs
احتیاجات	احتیاج	Ncl
احد	احد	Nas
احداث	احداث	Ncs
احزاب	حزب	Ncl
احساس	احساس	Ncs
احساسات	احساس	Ncl
احساسی	احساسی	As
احقاق	احقاق	Ncs
احوال	حال	Ncl
احیاء	احیاء	Ncs
اخبار	خبر	Ncl
اخباری	خبر	Ncl
اختصاص	اختصاص	Ncs
اختصاصی	اختصاصی	As
اختلاف	اختلاف	Ncs
اختلافات	اختلاف	Ncl
اختلال	اختلال	Ncs
اختلالات	اختلال	Ncl
اختیار	اختیار	Ncs
اخلاق	خلق	Ncs
اخلاقی	اخلاقی	As
اخیر	اخیر	As
ادا	ادا	Ncs
اداره	اداره	Ncs
ادامه	ادامه	Ncs
ادای	ادا	Ncs
ادبی	ادبی	As
ادرار	ادرار	Ncs
ادراری	ادراری	As
ادعا	ادعا	Ncs
ادعاها	ادعا	Ncl
ادعاهای	ادعا	Ncl
ادعای	ادعا	Ncs
ادوار	دور	Ncl
ادیان	دین	Ncl
اذعان	اذعان	Ncs
اراک	اراک	Nas
اراکی	اراکی	As
ارایه	ارایه	Ncs
ارائه	ارائه	Ncs
ارتباط	ارتباط	Ncs
ارتباطات	ارتباط	Ncl
ارتباطی	ارتباط	Ncs
ارتفاع	ارتفاع	Ncs
ارجاع	ارجاع	Ncs
ارجمند	ارجمند	As
اردوگاه	اردوگاه	Ncs
اردیبهشت	اردیبهشت	Nas
ارز	ارز	Ncs
ارزان	ارزان	As
ارزش	ارزش	Ncs
ارزشمند	ارزشمند	As
ارزشها	ارزش	Ncl
ارزشهای	ارزش	Ncl
ارزنده	ارزنده	As
ارزها	ارز	Ncl
ارزی	ارزی	As
ارزیابی	ارزیابی	Ncs
ارسال	ارسال	Ncs
ارشاد	ارشاد	Ncs
ارشد	ارشد	As
ارضای	ارضا	Ncs
ارقام	رقم	Ncl
ارکان	رکن	Ncl
اروپا	اروپا	Nas
اروپایی	اروپایی	As
ازای	ازا	Ncs
ازبکستان	ازبکستان	Nas
اساتید	استاد	Ncl
اسارت	اسارت	Ncs
اساس	اساس	Ncs
اساسی	اساسی	As
اسامه	اسامه	Nas
اسامی	اسم	Ncl
اسب	اسب	Ncs
اسبی	اسب	Ncs
اسپانیا	اسپانیا	Nas
اسپانیایی	اسپانیایی	As
اسپانیایی	اسپانیایی	Nas
است	بودن,است,بود	Vpy
استاد	استاد	Nas
استاد	استاد	Ncs
استالین	استالین	Nas
استالینیست	استالینیست	As
استامپی	استامپ	As
استان	استان	Ncs
استاندارد	استاندارد	Ncs
استانها	استان	Ncl
استبداد	استبداد	Ncs
استحضار	استحضار	Ncs
استخدام	استخدام	Ncs
استخوان	استخوان	Ncs
استخوانهای	استخوان	Ncl
استخوانی	استخوانی	As
استراتژی	استراتژی	Ncs
استراحت	استراحت	Ncs
استرالیا	استرالیا	Nas
استرداد	استرداد	Ncs
استعداد	استعداد	Ncs
استعلام	استعلام	Ncs
استعمال	استعمال	Ncs
استفاده	استفاده	Ncs
استفراغ	استفراغ	Ncs
استقامت	استقامت	Ncs
استقبال	استقبال	Ncs
استقلال	استقلال	Nas
استناد	استناد	Ncs
استنفورد	استنفورد	Nas
استوار	استوار	As
استیلایی	استیلا	Ncs
اسرائیل	اسرائیل	Nas
اسرائیلیها	اسرائیل	Nal
اسکوربیت	اسکوربیت	Ncs
اسلام	اسلام	Ncs
اسلامی	اسلامی	As
اسم	اسم	Ncs
اسمیت	اسمیت	Nas
اسناد	سند	Ncl
اسهال	سهل	Ncl
اسید	اسید	Ncs
اشاره	اشاره	Ncs
اشتباه	اشتباه	Ncs
اشتباها	اشتباها	Dg
اشتراکی	اشتراک	Ncs
اشتغال	اشتغال	Ncs
اشخاص	شخص	Ncl
اشرف	اشرف	As
اشعه	اشعه	Ncs
اشغالگر	اشغالگر	As
اشکالات	اشکال	Ncl
اشکانی	اشکانی	Nas
اصالت	اصالت	Ncs
اصطلاح	اصطلاح	Ncs
اصطلاحاتی	اصطلاح	Ncl
اصغر	اصغر	Nas
اصفهان	اصفهان	Nas
اصفهانی	اصفهانی	As
اصل	اصل	Ncs
اصلاح	اصلاح	Ncs
اصلاحات	اصلاح	Ncl
اصلاحاتی	اصلاح	Ncl
اصلی	اصلی	As
اصناف	صنف	Ncl
اصول	اصل	Ncl
اصولگرا	اصولگرا	As
اصیل	اصیل	As
اضافه	اضافه	As
اضافی	اضافی	As
اطرافیان	اطراف	Ncl
اطفال	طفل	Ncl
اطلاع	اطلاع	Ncs
اطلاعات	اطلاع	Nal
اطلاعات	اطلاع	Ncl
اطلاعاتی	اطلاعاتی	As
اطلاعی	اطلاع	Ncs
اطلاق	اطلاق	Ncs
اطلس	اطلس	Nas
اطمینان	اطمینان	Ncs
اظهار	اظهار	Ncs
اظهارات	اظهار	Ncl
اظهاراتی	اظهار	Ncl
اظهارنظرهای	اظهارنظر	Ncl
اعتبار	اعتبار	Ncs
اعتبارات	اعتبار	Ncl
اعتباری	اعتبار	Ncs
اعتراض	اعتراض	Ncs
اعتقاد	اعتقاد	Ncs
اعتقادات	اعتقاد	Ncl
اعتقادی	اعتقاد	Ncs
اعتقادی	اعتقادی	As
اعتماد	اعتماد	Ncs
اعتیاد	اعتیاد	Ncs
اعزام	اعزام	Ncs
اعضای	عضو	Ncl
اعطاء	اعطاء	Ncs
اعطای	اعطا	Ncs
اعلام	اعلام	Ncs
اعلامیه	اعلامیه	Ncs
اعماق	عمق	Ncl
اعمال	عمل	Ncl
اعمالی	عمل	Ncl
اغتشاش	اغتشاش	Ncs
اغراض	غرض	Ncl
اغلب	اغلب	Dg
اغلب	اغلب	Tf
اغما	اغما	Ncs
افت	افت	Ncs
افتادن	افتادن,افت,افتاد	Vp-
افتاده	افتادن,افت,افتاد	Vp-
افتتاح	افتتاح	Ncs
افراد	فرد	Ncl
افرادی	فرد	Ncl
افزایش	افزایش	Ncs
افزود	افزودن,افزا,افزود	Vpy
افزوده	افزودن,افزا,افزود	Vp-
افسانه	افسانه	Ncs
افسردگی	افسردگی	Ncs
افسرده	افسرده	As
افسوس	افسوس	I
افشا	افشا	Ncs
افشای	افشا	Ncs
افکار	فکر	Ncl
اقامت	اقامت	Ncs
اقامه	اقامه	Ncs
اقبال	اقبال	Ncs
اقتصادی	اقتصادی	As
اقتضا	اقتضا	Ncs
اقدام	اقدام	Ncs
اقدامات	اقدام	Ncl
اقدامی	اقدام	Ncs
اقسام	قسم	Ncl
اقشار	قشر	Ncl
اقلیت	اقلیت	Ncs
اقلیتی	اقلیت	Ncs
اقناع	اقناع	Ncs
اقوام	قوم	Ncl
اقیانوس	اقیانوس	Ncs
اقیانوسیه	اقیانوسیه	Nas
اکاذیب	اکذوبه	Ncl
اکبر	اکبر	Nas
اکثر	اکثر	Tf
اکثریت	اکثریت	Ncs
اکثریت	اکثریت	Tf
اکثریتی	اکثریت	Ncs
اکرم	اکرم	As
اکسیژن	اکسیژن	Nas
اکنون	اکنون	Dg
اکو	اکو	Nas
اگر	اگر	Jo
اگرچه	اگرچه	J-
البته	البته	Dg
التقاطیون	التقاط	Ncl
التهاب	التهاب	Ncs
التیام	التیام	Ncs
الجزایری	الجزایری	As
الحاقی	الحاقی	As
الزاماتی	الزام	Ncl
الف	الف	Nas
الف	الف	Ra
القا	القا	Ncs
الکترونیک	الکترونیک	As
الکترونیکی	الکترونیکی	As
الکتریک	الکتریک	Nas
الگوهای	الگو	Ncl
المپیک	المپیک	Nas
المیزان	المیزان	Nas
الهی	الهی	As
الهیات	الهیات	Ncs
اما	اما	J-
امام	امام	Nas
امامت	امامت	Ncs
امامی	امامی	As
امت	امت	Ncs
امتحان	امتحان	Ncs
امتیاز	امتیاز	Ncs
امثال	مثل	Ncl
امر	امر	Ncs
امرار	امرار	Ncs
امراض	مرض	Ncl
امروز	امروز	Dg
امروزه	امروزه	Dg
امریکا	امریکا	Nas
امسال	امسال	Dg
امضا	امضا	Ncs
امضاکنندگان	امضاکننده	Ncl
امضای	امضا	Ncs
امکان	امکان	Ncs
امکانات	امکان	Ncl
املاح	املاح	Ncs
املاک	ملک	Ncl
امن	امن	As
امنیت	امنیت	Ncs
امنیتی	امنیتی	As
امواج	موج	Ncl
اموال	مال	Ncl
امور	امر	Ncl
اموی	اموی	As
امید	امید	Ncs
امیدرضا	امیدرضا	Nas
امیدوار	امیدوار	As
امیدواری	امیدواری	Ncs
امیر	امیر	Nas
امیرخانی	امیرخانی	Nas
امیل	امیل	Nas
امین	امین	Nas
امینی	امینی	Nas
امینیان	امینیان	Nas
امیه	امیه	Nas
انبار	انبار	Ncs
انبوه	انبوه	As
انبوه	انبوه	Ncs
انتخاب	انتخاب	Nas
انتخاب	انتخاب	Ncs
انتخابات	انتخاب	Ncl
انتخاباتی	انتخاباتی	As
انتشار	انتشار	Ncs
انتظار	انتظار	Ncs
انتظارات	انتظار	Ncl
انتظامی	انتظامی	Nas
انتقاد	انتقاد	Ncs
انتقادات	انتقاد	Ncl
انتقال	انتقال	Ncs
انتهایی	انتهایی	As
انجام	انجام	Ncs
انجمن	انجمن	Ncs
انجمنهای	انجمن	Ncl
انجیل	انجیل	Nas
انحراف	انحراف	Ncs
انحرافی	انحرافی	As
انحلال	انحلال	Ncs
اند	اند	Ce
انداخت	انداختن,انداز,انداخت	Vpy
انداختن	انداختن,انداز,انداخت	Vp-
اندازه	اندازه	Ncs
اندامهای	اندام	Ncl
اندوه	اندوه	Ncs
اندی	اند	Ncs
اندیشمندان	اندیشمند	Ncl
اندیشمندی	اندیشمند	As
اندیشه	اندیشه	Ncs
انرژی	انرژی	Ncs
انسان	انسان	Ncs
انسانها	انسان	Ncl
انسانی	انسانی	As
انسجام	انسجام	Ncs
انصاری	انصاری	Nas
انصاف	انصاف	Ncs
انصافی	انصاف	Ncs
انفجار	انفجار	Ncs
انفرادی	انفرادی	As
انفرادی	انفرادی	Ncs
انفعالی	انفعالی	As
انقلاب	انقلاب	Ncs
انقلابی	انقلاب	Ncs
انقلابی	انقلابی	As
انکار	انکار	Ncs
انکارناپذیر	انکارناپذیر	As
انگارد	انگاشتن,انگار,انگاشت	Vpy
انگشتان	انگشت	Ncl
انگشتری	انگشتری	As
انگلستان	انگلستان	Nas
انگلی	انگلی	As
انگلیس	انگلیس	Nas
انگلیسی	انگلیسی	As
انگلیسی	انگلیسی	Nas
انگلیسیها	انگلیس	Nal
انگـور	انگـور	Ncs
انگور	انگور	Ncs
انگیختن	انگیختن,انگیز,انگیخت	Vp-
انگیزش	انگیزش	Ncs
انگیزه	انگیزه	Ncs
انواع	نوع	Ncl
انیماتور	انیماتور	Ncs
اواخر	آخرة	Ncl
اواسط	وسط	Ncl
اوایل	اول	Ncl
اوپک	اوپک	Nas
اوج	اوج	Ncs
اورامانات	اورامانات	Nas
اورژانس	اورژانس	Ncs
اوزاکای	اوزاکای	Nas
اوزان	وزن	Ncl
اوستلینگ	اوستلینگ	Nas
اوضاع	وضع	Ncl
اوغورمومجو	اوغورمومجو	Nas
اول	اول	Uo
اولین	اولین	Uo
اولیه	اولیه	As
اوهام	وهم	Ncl
اهالی	اهل	Ncl
اهتمام	اهتمام	Ncs
اهداف	هدف	Ncl
اهل	اهل	Ncs
اهمیت	اهمیت	Ncs
اهمیتی	اهمیت	Ncs
اهورامزدا	اهورامزدا	Nas
ایالات	ایالت	Ncl
ایالت	ایالت	Ncs
ایتالیا	ایتالیا	Nas
ایتالیاییها	ایتالیا	Nal
ایثار	ایثار	Ncs
ایثارگران	ایثارگر	Ncl
ایجاد	ایجاد	Ncs
ایجادشده	ایجادشده	As
ایدئولوژیک	ایدئولوژیک	As
ایراد	ایراد	Ncs
ایران	ایران	Nas
ایرانی	ایرانی	As
ایرانی	ایرانی	Nas
ایرانیان	ایران	Nal
ایرانیها	ایران	Nal
ایرج	ایرج	Nas
ایرسوتر	ایرسوتر	Nas
ایرنا	ایرنا	Nas
ایزد	ایزد	Ncs
ایستاد	ایستادن,ایست,ایستاد	Vpy
ایستادگی	ایستادگی	Ncs
ایستایی	ایستایی	Ncs
ایستگاه	ایستگاه	Ncs
ایسنا	ایسنا	Nas
ایشان	ایشان	Zrl
ایفای	ایفا	Ncs
ایل	ایل	Ncs
ایلام	ایلام	Nas
ایمان	ایمان	Ncs
ایمنی	ایمنی	As
این	این	Tm
این	این	Zms
اینان	اینان	Zml
اینترفرون	اینترفرون	Nas
اینترنت	اینترنت	Nas
اینجا	اینجا	Dg
ایندیپندنت	ایندیپندنت	Nas
اینکه	اینکه	J-
ائتلاف	ائتلاف	Ncs
آبرو	آبرو	Ncs
آبکی	آبکی	As
آبلمان	آبلمان	Nas
آبلمن	آبلمن	Nas
آبله	آبله	Ncs
آتش	آتش	Ncs
آتن	آتن	Nas
آتنیها	آتنیها	Nal
آتی	آتی	As
آثار	اثر	Ncl
آثاری	اثر	Ncl
آجرچینی	آجرچینی	Ncs
آجیل	آجیل	Ncs
آخر	آخر	Dg
آخر	آخر	Ncs
آخر	آخر	Uo
آخرین	آخرین	Uo
آدمها	آدم	Ncl
آدولف	آدولف	Nas
آرا	رأی	Ncl
آراء	رأی	Ncl
آرام	آرام	As
آرامش	آرامش	Ncs
آرامگاه	آرامگاه	Ncs
آران	آران	Nas
آرای	رأی	Ncl
آرایش	آرایش	Ncs
آرایشی	آرایشی	As
آرمانهای	آرمان	Ncl
آرمسترانگ	آرمسترانگ	Nas
آرمیده	آرمیدن,آرم,آرمید	Vp-
آزاد	آزاد	As
آزادانه	آزادانه	Dg
آزادی	آزادی	Ncs
آزادیها	آزادی	Ncl
آزاردهنده	آزاردهنده	As
آزتکها	آزتکها	Nal
آزمایش	آزمایش	Ncs
آزمایشگاه	آزمایشگاه	Ncs
آسان	آسان	As
آستانه	آستانه	Nas
آستانه	آستانه	Ncs
آسوده	آسوده	As
آسیا	آسیا	Nas
آسیایی	آسیایی	As
آسیب	آسیب	Ncs
آشفته	آشفته	As
آشکار	آشکار	As
آشکارا	آشکارا	Dg
آشنا	آشنا	As
آشوبی	آشوب	Ncs
آغاز	آغاز	Ncs
آغازی	آغاز	Ncs
آغازین	آغازین	As
آفات	آفت	Ncl
آفتاب	آفتاب	Ncs
آفریده	آفریدن,آفرین,آفرید	Vp-
آفریده	آفریده	Ncs
آفریقا	آفریقا	Nas
آفریقایی	آفریقایی	As
آقای	آقای	Nas
آقایان	آقا	Ncl
آکروپلیس	آکروپلیس	Nas
آگاه	آگاه	As
آگاهی	آگاهی	Ncs
آگهیهای	آگهی	Ncl
آلاباما	آلاباما	Nas
آلبرت	آلبرت	Nas
آلجین	آلجین	Nas
آلمان	آلمان	Nas
آلمانی	آلمانی	Nas
آلیاژ	آلیاژ	Ncs
آماج	آماج	Ncs
آمادگی	آمادگی	Ncs
آماده	آماده	As
آمار	آمار	Ncs
آماری	آماری	As
آمد	آمدن,آ,آمد	Vpy
آمدن	آمدن,آ,آمد	Vp-
آمده	آمدن,آ,آمد	Vp-
آمریکا	آمریکا	Nas
آمریکایی	آمریکایی	As
آمریکاییان	آمریکاییان	Nal
آمریکاییها	آمریکاییها	Nal
آمفیزم	آمفیزم	Nas
آموزش	آموزش	Ncs
آموزشگاه	آموزشگاه	Ncs
آموزشی	آموزشی	As
آمیخته	آمیختن,آمیز,آمیخت	Vp-
آنان	آنان	Zrl
آنانی	آنان	Zrl
آنجا	آنجا	Dg
آنجا	آنجا	Ncs
آنچه	آنچه	Zfs
آنفلوانزا	آنفلوانزا	Ncs
آنقدر	آنقدر	Di
آنگاه	آنگاه	J-
آننبرگ	آننبرگ	Nas
آنها	آنها	Zml
آنی	آن	As
آنی	آنی	As
آواز	آواز	Ncs
آورد	آوردن,آور,آورد	Vpy
آوردن	آوردن,آور,آورد	Vp-
آوردند	آوردن,آور,آورد	Vpy
آورده	آوردن,آور,آورد	Vp-
آورند	آوردن,آور,آورد	Vpy
آورید	آوردن,آور,آورد	Vpy
آوریل	آوریل	Nas
آوریم	آوردن,آور,آورد	Vpy
آهک	آهک	Ncs
آهن	آهن	Ncs
آهنگ	آهنگ	Ncs
آهنگی	آهنگ	Ncs
آهووشی	آهووش	Ncs
آیا	آیا	Dg
آیات	آیه	Ncl
آیةالله	آیةالله	Nas
آید	آمدن,آ,آمد	Vpy
آینده	آینده	Ncs
آیینی	آیینی	As
آئینه	آئینه	Ncs
باتجربه	باتجربه	As
باتقوای	باتقوای	As
باخت	باخت	Ncs
باد	باد	Ncs
بادرود	بادرود	Nas
بار	بار	Dg
بار	بار	Ls
بار	بار	Ncs
باران	باران	Ncs
باردار	باردار	As
بارداری	بارداری	Ncs
بارداریها	بارداری	Ncl
بارگاه	بارگاه	Ncs
بارگر	بارگر	Nas
بارها	بارها	Dg
باز	باز	As
باز	باز	Dg
بازار	بازار	Ncs
بازاریهای	بازاری	Ncl
بازپرسان	بازپرس	Ncl
بازرسی	بازرسی	Ncs
بازسازی	بازسازی	Ncs
بازشماری	بازشماری	Ncs
بازگرداندن	بازگرداندن	Ncs
بازگو	بازگو	Ncs
بازماندگان	بازمانده	Ncl
بازنمایی	بازنمایی	Ncs
بازهم	بازهم	Dg
بازی	بازی	Ncs
بازیکن	بازیکن	Ncs
بازیکنان	بازیکن	Ncl
بازیگر	بازیگر	Ncs
بازیگران	بازیگر	Ncl
بازیهای	بازی	Ncl
باستان	باستان	As
باستانی	باستانی	As
باستانی	باستانی	Nas
باشد	بودن,باش,بود	Vpy
باشگاههای	باشگاه	Ncl
باشند	بودن,باش,بود	Vpy
باشید	بودن,باش,بود	Vpy
باشیم	بودن,باش,بود	Vpy
باطل	باطل	As
باطل	باطل	Ncs
باظرافت	باظرافت	As
باعث	باعث	As
بافتها	بافت	Ncl
بافتهای	بافت	Ncl
باقر	باقر	Nas
باقی	باقی	Ncs
باقیمانده	باقیمانده	As
باکتری	باکتری	Ncs
بالا	بالا	Dg
بالاتر	بالا	Ac
بالاترین	بالا	Au
بالاخره	بالاخره	Dg
بالاخص	بالاخص	Dg
بالای	بالای	As
بالای	بالای	Ez
بالایی	بالا	As
بالعکس	بالعکس	Dg
بالغ	بالغ	Ncs
بالغین	بالغ	Ncl
بالقوه	بالقوه	As
باند	باند	Ncs
بانک	بانک	Ncs
بانکوک	بانکوک	Nas
بانکی	بانکی	As
بانگ	بانگ	Ncs
باور	باور	Ncs
باورها	باور	Ncl
باورهای	باور	Ncl
باوری	باور	Ncs
باهنر	باهنر	Nas
باید	باید,باید,باید	Vpx
بایندر	بایندر	Nas
ببرد	بردن,بر,برد	Vpy
ببرند	بردن,بر,برد	Vpy
ببریم	بردن,بر,برد	Vpy
ببینید	دیدن,بین,دید	Vpy
بپردازند	پرداختن,پرداز,پرداخت	Vpy
بتا	بتا	Nas
بتابد	تابیدن,تاب,تابید	Vpy
بتدریج	تدریج	Dg
بتواند	توانستن,توان,توانست	Vpx
بتوانند	توانستن,توان,توانست	Vpx
بتوانیم	توانستن,توان,توانست	Vpx
بجز	بجز	E-
بجنورد	بجنورد	Nas
بچش	چشیدن,چش,چشید	Vpy
بحث	بحث	Ncs
بحثها	بحث	Ncl
بحثهای	بحث	Ncl
بحثی	بحث	Ncs
بحران	بحران	Ncs
بحرانهای	بحران	Ncl
بخت	بخت	Ncs
بختیاری	بختیاری	Nas
بخرد	خریدن,خر,خرید	Vpy
بخش	بخش	Ncs
بخشد	بخشیدن,بخش,بخشید	Vpy
بخشهای	بخش	Ncl
بخشی	بخش	Ncs
بخشیدن	بخشیدن,بخش,بخشید	Vp-
بخصوص	بخصوص	Dg
بخوانند	خواندن,خوان,خواند	Vpy
بخواهد	خواستن,خواه,خواست	Vpy
بخوبی	بخوبی	Dg
بخورد	خوردن,خور,خورد	Vpy
بخورند	خوردن,خور,خورد	Vpy
بداریم	داشتن,دار,داشت	Vpy
بداند	دانستن,دان,دانست	Vpy
بدانند	دانستن,دان,دانست	Vpy
بدانید	دانستن,دان,دانست	Vpy
بدانیم	دانستن,دان,دانست	Vpy
بدبین	بدبین	As
بدبینی	بدبینی	Ncs
بدخیم	بدخیم	As
بدرقه	بدرقه	Ncs
بدگویی	بدگویی	Ncs
بدن	بدن	Ncs
بدنام	بدنام	As
بدون	بدون	Ez
بدهد	دادن,ده,داد	Vpy
بدهی	بدهی	Ncs
بدهیم	دادن,ده,داد	Vpy
بدیع	بدیع	As
بدیهی	بدیهی	As
برا	برا	E-
برابر	برابر	Ez
برابر	برابر	Ncs
برابری	برابری	Ncs
برادر	برادر	Ncs
برادران	برادر	Ncl
برانداز	برانداز	As
براندازی	براندازی	Ncs
براندز	براندز	Nas
برانگیخته	برانگیخته	Ncs
برانگیزاننده	برانگیزاننده	As
برای	برای	Ez
برآورد	برآورد	Ncs
برآوردها	برآورد	Ncl
برآوردهای	برآورد	Ncl
برتر	بر	Ac
برتری	برتری	Ncs
برج	برج	Ncs
برجسته	برجسته	As
برخاسته	برخاسته	As
برخورد	برخورد	Ncs
برخوردار	برخوردار	As
برخی	برخی	Tf
برد	برد	Ncs
برد	بردن,بر,برد	Vpy
بردند	بردن,بر,برد	Vpy
برده	بردن,بر,برد	Vp-
بررسی	بررسی	Ncs
بررسیهای	بررسی	Ncl
برزیلی	برزیلی	Nas
برسد	رسیدن,رس,رسید	Vpy
برطرف	برطرف	As
برعکس	برعکس	Dg
برق	برق	Ncs
برقرار	برقرار	As
برقراری	برقرار	Ncs
برکه	برکه	Ncs
برگ	برگ	Ncs
برگزار	برگزار	As
برگزاری	برگزاری	Ncs
برگشت	برگشت	Ncs
برلین	برلین	Nas
برنامه	برنامه	Ncs
برنج	برنج	Ncs
برنجین	برنجین	As
برند	رفتن,رو,رفت	Vpy
برنده	برنده	Ncs
برنز	برنز	Ncs
بروز	بروز	Ncs
بروکسل	بروکسل	Nas
بروند	رفتن,رو,رفت	Vpy
برونشیت	برونشیت	Ncs
بروی	رفتن,رو,رفت	Vpy
بری	بری	Nas
بریتانیا	بریتانیا	Nas
بریده	بریده	As
بریزبن	بریزبن	Nas
بزرگ	بزرگ	As
بزرگان	بزرگ	Ncl
بزرگانی	بزرگ	Ncl
بزرگترین	بزرگ	Au
بزرگسالها	بزرگسال	Ncl
بزرگی	بزرگ	As
بزند	زدن,زن,زد	Vpy
بزنند	زدن,زن,زد	Vpy
بسادگی	بسادگی	Dg
بسازد	ساختن,ساز,ساخت	Vpy
بسازند	ساختن,ساز,ساخت	Vpy
بساط	بساط	Ncs
بستر	بستر	Ncs
بستری	بستری	As
بستگی	بستگی	Ncs
بستن	بستن,بند,بست	Vp-
بستند	بستن,بند,بست	Vpy
بسته	بسته	Ncs
بسوزاند	سوزاندن,سوزان,سوزاند	Vpy
بسیار	بسیار	As
بسیار	بسیار	Dg
بسیار	بسیار	Di
بسیاری	بسیار	As
بسیاری	بسیاری	Tf
بصره	بصره	Nas
بعد	بعد	Dg
بعد	بعد	E-
بعد	بعد	J-
بعدا	بعدا	Dg
بعدازظهر	بعدازظهر	Ncs
بعدها	بعدها	Dg
بعدی	بعدی	As
بعضی	بعضی	Tf
بعید	بعید	As
بغل	بغل	Ncs
بفرمایید	فرمودن,فرما,فرمود	Vpy
بقای	بقا	Ncs
بقیه	بقیه	Ncs
بکشند	کشتن,کش,کشت	Vpy
بکشند	کشیدن,کش,کشید	Vpy
بکشیم	کشتن,کش,کشت	Vpy
بکشیم	کشیدن,کش,کشید	Vpy
بکند	کردن,کن,کرد	Vpy
بکنند	کردن,کن,کرد	Vpy
بگذارد	گذاشتن,گذار,گذاشت	Vpy
بگذارند	گذاشتن,گذار,گذاشت	Vpy
بگشایند	گشودن,گشا,گشود	Vpy
بگوید	گفتن,گو,گفت	Vpy
بگیرد	گرفتن,گیر,گرفت	Vpy
بگیرند	گرفتن,گیر,گرفت	Vpy
بلاتکلیف	بلاتکلیف	As
بلاتکلیفی	بلاتکلیفی	Ncs
بلاش	بلاش	Nas
بلافاصله	بلافاصله	Dg
بلژیک	بلژیک	Nas
بلکه	بلکه	J-
بلکه	بلکه	Jr
بلند	بلند	As
بلومر	بلومر	Nas
بمیرم	مردن,میر,مرد	Vpy
بنا	بنا	Ncs
بنابراین	بنابراین	J-
بنادر	بندر	Ncl
بنامد	نامیدن,نام,نامید	Vpy
بنان	بنان	Nas
بناهای	بنا	Ncl
بنای	بنا	Ncs
بند	بند	Ncs
بندر	بندر	Ncs
بندرعباس	بندرعباس	Nas
بنده	بنده	Ncs
بنشینیم	نشستن,نشین,نشست	Vpy
بنگ	بنگ	Nas
بنیاد	بنیاد	Ncs
بنیادگراها	بنیادگرا	Ncl
بنیادین	بنیادین	As
بود	بودن,باش,بود	Vpy
بودجویس	بودجویس	Nas
بودجه	بودجه	Ncs
بودم	بودن,باش,بود	Vpy
بودن	بودن,باش,بود	Vp-
بودند	بودن,باش,بود	Vpy
بوده	بودن,باش,بود	Vp-
بودیم	بودن,باش,بود	Vpy
بورس	بورس	Ncs
بورن	بورن	Nas
بورونوگرافی	بورونوگرافی	Ncs
بوستان	بوستان	Ncs
بوکس	بوکس	Ncs
بوکسور	بوکسور	Ncs
بومی	بومی	As
بویژه	بویژه	Dg
بوئینگ	بوئینگ	Nas
بهار	بهار	Nas
بهار	بهار	Ncs
بهاری	بهاری	Nas
بهانه	بهانه	Ncs
بهای	بها	Ncs
بهبود	بهبود	Ncs
بهبودی	بهبودی	Ncs
بهتر	به	Ac
بهتری	به	Ac
بهترین	به	Au
بهداشت	بهداشت	Ncs
بهداشتی	بهداشتی	As
بهره	بهره	Ncs
بهزاد	بهزاد	Nas
بهمن	بهمن	Nas
بهمنی	بهمنی	Nas
بیابند	یافتن,یاب,یافت	Vpy
بیافریند	آفریدن,آفرین,آفرید	Vpy
بیافکنند	افکندن,افکن,افکند	Vpy
بیان	بیان	Nas
بیان	بیان	Ncs
بیانگر	بیانگر	Ncs
بیانیه	بیانیه	Ncs
بیاورد	آوردن,آور,آورد	Vpy
بیایید	آمدن,آ,آمد	Vpy
بیائو	بیائو	Nas
بیدگل	بیدگل	Nas
بیرون	بیرون	Dg
بیرونی	بیرونی	As
بیزاری	بیزاری	Ncs
بیست	بیست	Ur
بیستم	بیستم	Uo
بیش	بیش	As
بیشتر	بیش	Ac
بیشتر	بیشتر	Dg
بیشتر	بیشتر	Di
بیشتری	بیش	Ac
بیشترین	بیش	Au
بیشماری	بیشمار	As
بیفتد	افتادن,افت,افتاد	Vpy
بیکار	بیکار	As
بیگانه	بیگانه	As
بیگاه	بیگاه	As
بیگمان	بیگمان	Dg
بیم	بیم	Ncs
بیمار	بیمار	As
بیمار	بیمار	Ncs
بیماران	بیمار	Ncl
بیمارانی	بیمار	Ncl
بیمارستان	بیمارستان	Ncs
بیمارستانهای	بیمارستان	Ncl
بیماری	بیمار	As
بیماری	بیماری	Ncs
بیماریها	بیماری	Ncl
بیماریهای	بیماری	Ncl
بیماریهایی	بیماری	Ncl
بین	بین	Ez
بین	بین	Ncs
بینندگان	بیننده	Ncl
بینندگانی	بیننده	Ncl
بیننده	بیننده	Ncs
بیوشیمیایی	بیوشیمیایی	As
بیهاری	بیهاری	Nas
پابلو	پابلو	Nas
پاپ	پاپ	Nas
پادشاه	پادشاه	Ncs
پادشاهی	پادشاهی	Ncs
پارتنون	پارتنون	Nas
پارسایانه	پارسایانه	Dg
پارک	پارک	Ncs
پارکر	پارکر	Nas
پارکینسون	پارکینسون	Nas
پارلمان	پارلمان	Ncs
پارلمانی	پارلمانی	As
پاره	پاره	As
پاریزی	پاریزی	Nas
پاسخ	پاسخ	Ncs
پاسخگوی	پاسخگو	Ncs
پاسدار	پاسدار	Ncs
پاسداران	پاسدار	Ncl
پاسداری	پاسداری	Ncs
پاشیدن	پاشیدن,پاش,پاشید	Vp-
پاک	پاک	As
پاکسازی	پاکسازی	Ncs
پالرمو	پالرمو	Nas
پانزدهمین	پانزدهمین	Uo
پاوه	پاوه	Nas
پای	پا	Ncs
پای	پای	Ncs
پایان	پایان	Ncs
پایانبخش	پایانبخش	Ncs
پایتخت	پایتخت	Ncs
پایدار	پایدار	As
پایداری	پایداری	Ncs
پایگاه	پایگاه	Ncs
پایه	پایه	Ncs
پایین	پایین	As
پایین	پایین	Dg
پایین	پایین	Ez
پتاسیم	پتاسیم	Ncs
پتانسیل	پتانسیل	Ncs
پتانسیلی	پتانسیل	Ncs
پتی	پتی	Nas
پخش	پخش	Ncs
پدر	پدر	Ncs
پدید	پدید	As
پدیدار	پدیدار	Ncs
پدیده	پدیده	Ncs
پذیرای	پذیرای	As
پذیرایی	پذیرایی	Ncs
پذیرش	پذیرش	Ncs
پذیرفتند	پذیرفتن,پذیر,پذیرفت	Vpy
پذیرفتنی	پذیرفتنی	As
پراکنده	پراکنده	As
پراگ	پراگ	Nas
پراهمیتی	پراهمیت	As
پرتاب	پرتاب	Ncs
پرتغال	پرتغال	Nas
پرتیراژترین	پرتیراژ	Au
پرخاشگرانه	پرخاشگرانه	As
پرخاطره	پرخاطره	As
پرداخت	پرداخت	Ncs
پرداخت	پرداختن,پرداز,پرداخت	Vpy
پرداختن	پرداختن,پرداز,پرداخت	Vp-
پرداختی	پرداخت	Ncs
پرده	پرده	Ncs
پرسش	پرسش	Ncs
پرسه	پرسه	Ncs
پرسید	پرسیدن,پرس,پرسید	Vpy
پرشکوه	پرشکوه	As
پرنکته	پرنکته	As
پرواز	پرواز	Ncs
پرواضح	پرواضح	As
پروپاقرص	پروپاقرص	As
پروتئین	پروتئین	Ncs
پروتئینها	پروتئین	Ncl
پروردگار	پروردگار	Ncs
پرورش	پرورش	Ncs
پروژه	پروژه	Ncs
پروستات	پروستات	Nas
پرونده	پرونده	Ncs
پرهیز	پرهیز	Ncs
پریتچارد	پریتچارد	Nas
پریده	پریدن,پر,پرید	Vp-
پریروز	پریروز	Dg
پزشک	پزشک	Ncs
پزشکان	پزشک	Ncl
پزشکی	پزشک	Ncs
پزشکی	پزشکی	As
پزشکی	پزشکی	Ncs
پژواکی	پژواک	Ncs
پژوهش	پژوهش	Ncs
پژوهشگران	پژوهشگر	Ncl
پژوهشها	پژوهش	Ncl
پژوهشهای	پژوهش	Ncl
پژوهشی	پژوهشی	As
پست	پست	Ncs
پستها	پست	Ncl
پستهای	پست	Ncl
پسر	پسر	Ncs
پسران	پسر	Ncl
پشت	پشت	Ez
پشت	پشت	Ncs
پشتیبانی	پشتیبانی	Ncs
پکن	پکن	Nas
پگاه	پگاه	Ncs
پلوتونیم	پلوتونیم	Ncs
پلیس	پلیس	Ncs
پنالتی	پنالتی	Ncs
پناه	پناه	Ncs
پناهندگان	پناهنده	Ncl
پناهندگی	پناهندگی	Ncs
پنج	پنج	Ur
پنجاه	پنجاه	Ur
پنجاهمین	پنجاهمین	Uo
پنجساله	پنجساله	As
پنجشنبه	پنجشنبه	Nas
پنجم	پنجم	Uo
پنجمی	پنجمی	Uo
پنهان	پنهان	As
پوردو	پوردو	Nas
پوست	پوست	Ncs
پوستی	پوستی	As
پوسیدگی	پوسیدگی	Ncs
پوشش	پوشش	Ncs
پوک	پوک	As
پوکی	پوکی	Ncs
پول	پول	Ncs
پوند	پوند	Nas
پوندی	پوندی	Rj
پهلوی	پهلوی	Nas
پیاده	پیاده	As
پیامبر	پیامبر	Nas
پیامهای	پیام	Ncl
پیچیده	پیچیده	As
پیدا	پیدا	As
پیدایش	پیدایش	Ncs
پیرامون	پیرامون	Ez
پیرتر	پیر	Ac
پیرترین	پیر	Au
پیرنیا	پیرنیا	Nas
پیروان	پیرو	Ncl
پیروز	پیروز	As
پیروزی	پیروزی	Ncs
پیروی	پیروی	Ncs
پیری	پیری	Ncs
پیش	پیش	Dg
پیش	پیش	E-
پیش	پیش	Ez
پیشانی	پیشانی	Ncs
پیشرفت	پیشرفت	Ncs
پیشرفته	پیشرفته	As
پیشرفتهای	پیشرفت	Ncl
پیشرفتهایی	پیشرفت	Ncl
پیشکش	پیشکش	Ncs
پیشگیری	پیشگیری	Ncs
پیشنهاد	پیشنهاد	Ncs
پیشنهادهای	پیشنهاد	Ncl
پیشین	پیشین	As
پیکارها	پیکار	Ncl
پیکارهای	پیکار	Ncl
پیکاسو	پیکاسو	Nas
پیکر	پیکر	Ncs
پیگرد	پیگرد	Ncs
پیگیری	پیگیری	Ncs
پیوند	پیوند	Ncs
پیوندهای	پیوند	Ncl
تابستان	تابستان	Ncs
تابلو	تابلو	Ncs
تابلوی	تابلو	Ncs
تابید	تابیدن,تاب,تابید	Vpy
تاتارستان	تاتارستان	Nas
تاثیر	تاثیر	Ncs
تأثیر	تأثیر	Ncs
تاثیربرانگیز	تاثیربرانگیز	As
تأثیرپذیری	تأثیرپذیری	Ncs
تأثیرگذار	تأثیرگذار	As
تاثیرگذاری	تاثیرگذاری	Ncs
تاثیری	تاثیر	Ncs
تاجیک	تاجیک	Nas
تاخیر	تاخیر	Ncs
تأخیر	تأخیر	Ncs
تارتر	تارتر	Ncs
تارهای	تار	Ncl
تاری	تار	Ncs
تاریخ	تاریخ	Ncs
تاریخچه	تاریخچه	Ncs
تاریخی	تاریخی	As
تازه	تازه	As
تأسف	تأسف	Ncs
تأسیس	تأسیس	Ncs
تاکنون	تاکنون	Dg
تاکید	تاکید	Ncs
تأکید	تأکید	Ncs
تالار	تالار	Ncs
تالش	تالش	Nas
تألیف	تألیف	Ncs
تأمل	تأمل	Ncs
تأملی	تأمل	Ncs
تامین	تامین	Ncs
تأمین	تأمین	Ncs
تان	تان	Ce
تأهل	تأهل	Ncs
تایلند	تایلند	Nas
تایمز	تایمز	Nas
تایوان	تایوان	Nas
تایید	تایید	Ncs
تأیید	تأیید	Ncs
تاییدشده	تاییدشده	As
تبادل	تبادل	Ncs
تبخالهای	تبخال	Ncl
تبدیل	تبدیل	Ncs
تبعه	تبعه	Ncs
تبعید	تبعید	Ncs
تبلیغات	تبلیغ	Ncl
تبلیغاتی	تبلیغ	Ncl
تبلیغاتی	تبلیغاتی	As
تبهکاری	تبهکاری	As
تبیین	تبیین	Ncs
تپش	تپش	Ncs
تجارت	تجارت	Ncs
تجاری	تجاری	As
تجاوز	تجاوز	Ncs
تجاوزات	تجاوز	Ncl
تجدیدکننده	تجدیدکننده	Ncs
تجدیدنظرطلبانه	تجدیدنظرطلبانه	As
تجربه	تجربه	Ncs
تجسمی	تجسمی	As
تجمع	تجمع	Ncs
تجویز	تجویز	Ncs
تحت	تحت	Ez
تحتانی	تحتانی	As
تحجر	تحجر	Ncs
تحریریه	تحریریه	As
تحریک	تحریک	Ncs
تحریم	تحریم	Ncs
تحریمها	تحریم	Ncl
تحریمهای	تحریم	Ncl
تحسین	تحسین	Ncs
تحصیل	تحصیل	Ncs
تحصیلات	تحصیل	Ncl
تحقیق	تحقیق	Ncs
تحقیقات	تحقیق	Ncl
تحقیقاتی	تحقیقاتی	As
تحقیقی	تحقیق	Ncs
تحقیقی	تحقیقی	As
تحکم	تحکم	Ncs
تحکیم	تحکیم	Ncs
تحلیل	تحلیل	Ncs
تحلیلهای	تحلیل	Ncl
تحمل	تحمل	Ncs
تحمیل	تحمیل	Ncs
تحول	تحول	Ncs
تحولات	تحول	Ncl
تحویل	تحویل	Ncs
تخته	تخته	Ncs
تختی	تختی	Nas
تخریب	تخریب	Ncs
تخصصی	تخصصی	As
تخصیص	تخصیص	Ncs
تخفیف	تخفیف	Ncs
تخلفات	تخلف	Ncl
تخلفهای	تخلف	Ncl
تخلیه	تخلیه	Ncs
تخمدانها	تخمدان	Ncl
تخمین	تخمین	Ncs
تخیل	تخیل	Ncs
تخیلی	تخیلی	As
تدابیر	تدبیر	Ncl
تداوم	تداوم	Ncs
تدبیر	تدبیر	Ncs
ترابری	ترابری	Ncs
تراش	تراش	Ncs
تراکم	تراکم	Ncs
ترانزیت	ترانزیت	As
ترانزیت	ترانزیت	Ncs
ترتیب	ترتیب	Ncs
ترجیحات	ترجیح	Ncl
تردد	تردد	Ncs
تردیدی	تردید	Ncs
ترز	ترز	Nas
ترس	ترس	Ncs
ترسناک	ترسناک	As
ترسها	ترس	Ncl
ترفند	ترفند	Ncs
ترک	ترک	Ncs
ترکیبی	ترکیب	Ncs
ترکیه	ترکیه	Nas
ترمیم	ترمیم	Ncs
ترور	ترور	Ncs
ترویج	ترویج	Ncs
تزریق	تزریق	Ncs
تسلط	تسلط	Ncs
تسلیت	تسلیت	Ncs
تسلیم	تسلیم	Ncs
تشخیص	تشخیص	Ncs
تشدید	تشدید	Ncs
تشکل	تشکل	Ncs
تشکلها	تشکل	Ncl
تشکلهای	تشکل	Ncl
تشکیل	تشکیل	Ncs
تشکیلاتی	تشکیلاتی	As
تشنج	تشنج	Ncs
تشنجات	تشنج	Ncl
تشیع	تشیع	Ncs
تصادف	تصادف	Ncs
تصادفی	تصادفی	As
تصاویری	تصویر	Ncl
تصحیح	تصحیح	Ncs
تصرف	تصرف	Ncs
تصریح	تصریح	Ncs
تصفیه	تصفیه	Ncs
تصمیم	تصمیم	Ncs
تصمیمات	تصمیم	Ncl
تصور	تصور	Ncs
تصویب	تصویب	Ncs
تصویر	تصویر	Ncs
تصویرساز	تصویرساز	Ncs
تصویرسازی	تصویرسازی	Ncs
تصویرسازیهای	تصویرسازی	Ncl
تصویری	تصویر	Ncs
تضعیف	تضعیف	Ncs
تضمین	تضمین	Ncs
تطبیق	تطبیق	Ncs
تعادل	تعادل	Ncs
تعارض	تعارض	Ncs
تعارضی	تعارض	Ncs
تعاریف	تعریف	Ncl
تعامل	تعامل	Ncs
تعبیر	تعبیر	Ncs
تعجب	تعجب	Ncs
تعداد	تعداد	Ncs
تعدادی	تعداد	Ncs
تعریف	تعریف	Ncs
تعطیل	تعطیل	As
تعطیلی	تعطیلی	Ncs
تعظیم	تعظیم	Ncs
تعلق	تعلق	Ncs
تعمیق	تعمیق	Ncs
تعویق	تعویق	Ncs
تعیین	تعیین	Ncs
تغذیه	تغذیه	Ncs
تغییر	تغییر	Ncs
تغییرات	تغییر	Ncl
تفاوت	تفاوت	Ncs
تفحص	تفحص	Ncs
تفریحی	تفریحی	As
تفسیر	تفسیر	Ncs
تفسیری	تفسیر	Ncs
تقابل	تقابل	Ncs
تقاضا	تقاضا	Ncs
تقاضای	تقاضا	Ncs
تقبل	تقبل	Ncs
تقدیر	تقدیر	Ncs
تقریبا	تقریبا	Dg
تقسیم	تقسیم	Ncs
تقلب	تقلب	Ncs
تقلبهای	تقلب	Ncl
تقلید	تقلید	Ncs
تقوای	تقوا	Ncs
تقویت	تقویت	Ncs
تکذیب	تکذیب	Ncs
تکرار	تکرار	Ncs
تکراری	تکراری	As
تکلیف	تکلیف	Ncs
تکمیل	تکمیل	Ncs
تکنیک	تکنیک	Ncs
تکواندو	تکواندو	Ncs
تکواندوکار	تکواندوکار	Ncs
تکواندوکاران	تکواندوکار	Ncl
تکیه	تکیه	Ncs
تگزاس	تگزاس	Nas
تلاش	تلاش	Ncs
تلخ	تلخ	As
تلسکوپ	تلسکوپ	Ncs
تلسکوپی	تلسکوپ	Ncs
تلطیف	تلطیف	Ncs
تلف	تلف	Ncs
تلفن	تلفن	Ncs
تلفنی	تلفنی	As
تلفیقی	تلفیق	Ncs
تلقی	تلقی	Ncs
تلویزیون	تلویزیون	Ncs
تلویزیونی	تلویزیونی	As
تماس	تماس	Ncs
تماشا	تماشا	Ncs
تماشاگر	تماشاگر	Ncs
تماشاگران	تماشاگر	Ncl
تماشاگرانی	تماشاگر	Ncl
تماشای	تماشا	Ncs
تمام	تمام	As
تمام	تمام	Tf
تماما	تماما	Di
تمامی	تمام	Tf
تمایل	تمایل	Ncs
تمایلات	تمایل	Ncl
تمبر	تمبر	Ncs
تمبرها	تمبر	Ncl
تمبرهای	تمبر	Ncl
تمجید	تمجید	Ncs
تمدن	تمدن	Ncs
تمدنهای	تمدن	Ncl
تمرینهای	تمرین	Ncl
تمسک	تمسک	Ncs
تمهیدات	تمهید	Ncl
تمیز	تمیز	As
تنبیه	تنبیه	Ncs
تند	تند	As
تندرو	تندرو	As
تندیس	تندیس	Ncs
تندیسها	تندیس	Ncl
تندیسهای	تندیس	Ncl
تنسی	تنسی	Nas
تنش	تنش	Ncs
تنشها	تنش	Ncl
تنظیم	تنظیم	Ncs
تنفسی	تنفسی	As
تنوع	تنوع	Ncs
تنومند	تنومند	As
تنها	تنها	As
تنها	تنها	Dg
تنها	تنها	Di
تنهایی	تنها	Ncs
تنیده	تنیدن,تن,تنید	Vp-
تواضع	تواضع	Ncs
توأم	توأم	As
توان	توان	Ncs
توانا	توانا	As
توانایی	توانایی	Ncs
تواناییهای	توانایی	Ncl
توانسته	توانستن,توان,توانست	Vpx
توبه	توبه	Ncs
توجه	توجه	Ncs
توجیه	توجیه	Ncs
تورم	تورم	Ncs
توسط	توسط	Ez
توسعه	توسعه	Ncs
توسل	توسل	Ncs
توصیف	توصیف	Ncs
توصیه	توصیه	Ncs
توضیحات	توضیح	Ncl
توضیحاتی	توضیح	Ncl
توطئه	توطئه	Ncs
توقع	توقع	Ncs
توقف	توقف	Ncs
توقیف	توقیف	Ncs
توکسمی	توکسمی	Ncs
توکیو	توکیو	Nas
تولد	تولد	Ncs
تولید	تولید	Ncs
تولیدکننده	تولیدکننده	Ncs
توماس	توماس	Nas
تومور	تومور	Ncs
تومورهای	تومور	Nal
تونل	تونل	Ncs
تهاجم	تهاجم	Ncs
تهدید	تهدید	Ncs
تهران	تهران	Nas
تهوع	تهوع	Ncs
تهیه	تهیه	Ncs
تیپهای	تیپ	Ncl
تیتر	تیتر	Ncs
تیترها	تیتر	Ncl
تیر	تیر	Nas
تیراندازی	تیراندازی	Ncs
تیره	تیره	As
تیزهوشی	تیزهوشی	Ncs
تیغ	تیغ	Ncs
تیم	تیم	Ncs
تیمور	تیمور	Nas
تیمهای	تیم	Ncl
تیمی	تیمی	As
تئوری	تئوری	Ncs
تئوریهای	تئوری	Ncl
ثابت	ثابت	As
ثابت	ثابت	Dg
ثبات	ثبات	Ncs
ثبت	ثبت	Ncs
ثمر	ثمر	Ncs
جادو	جادو	Ncs
جاده	جاده	Ncs
جاری	جاری	As
جاسوسان	جاسوس	Ncl
جالب	جالب	As
جام	جام	Ncs
جامد	جامد	As
جامع	جامع	As
جامعه	جامعه	Ncs
جان	جان	Nas
جان	جان	Ncs
جانت	جانت	Nas
جانسون	جانسون	Nas
جانور	جانور	Ncs
جانوری	جانور	As
جاویدان	جاویدان	As
جای	جا	Ncs
جای	جای	Ncs
جایزه	جایزه	Ncs
جایگزین	جایگزین	As
جایگزینی	جایگزینی	Ncs
جایی	جا	Ncs
جبران	جبران	Ncs
جبهه	جبهه	Ncs
جدا	جدا	As
جدار	جدار	Ncs
جدایی	جدایی	Ncs
جدی	جدی	As
جدید	جدید	As
جدیدی	جدید	As
جذب	جذب	Ncs
جذبه	جذبه	Ncs
جرأتی	جرأت	Ncs
جراحی	جراحی	Ncs
جرایم	جریمه	Ncl
جرزهای	جرز	Ncl
جرمی	جرم	Ncs
جریان	جریان	Ncs
جریانات	جریان	Ncl
جریانی	جریان	Ncs
جزء	جزء	As
جزر	جزر	Ncs
جزرومد	جزرومد	Ncs
جزو	جزو	Ncs
جزوات	جزوه	Ncl
جزیره	جزیره	Ncs
جزیی	جزیی	As
جزییات	جزء	Ncl
جزئیات	جزء	Ncl
جست	جستن,جوی,جست	Vpy
جستجو	جستجو	Ncs
جستجوی	جستجو	Ncs
جسد	جسد	Ncs
جسدهای	جسد	Ncl
جشن	جشن	Ncs
جشنواره	جشنواره	Ncs
جشنها	جشن	Ncl
جعل	جعل	Ncs
جفرسون	جفرسون	Nas
جگر	جگر	Ncs
جلب	جلب	Ncs
جلد	جلد	Ls
جلد	جلد	Ncs
جلسه	جلسه	Ncs
جلوتر	جلو	Ac
جلوگیری	جلوگیری	Ncs
جلوه	جلوه	Ncs
جلوی	جلوی	Ncs
جمجمه	جمجمه	Ncs
جمع	جمع	Ncs
جمعه	جمعه	Nas
جمعی	جمعی	As
جمعی	جمعی	Tf
جمعیت	جمعیت	Ncs
جملات	جمل	Ncl
جمله	جمله	Ncs
جمود	جمود	Ncs
جمهوری	جمهوری	Ncs
جناب	جناب	Nas
جنابعالی	جنابعالی	Zrs
جناح	جناح	Ncs
جناحها	جناح	Ncl
جناحهای	جناح	Ncl
جناحی	جناح	Ncs
جناحی	جناحی	As
جنایات	جنایت	Ncl
جنبش	جنبش	Ncs
جنبه	جنبه	Ncs
جنبی	جنبی	As
جنجال	جنجال	Ncs
جنس	جنس	Ncs
جنگ	جنگ	Ncs
جنوب	جنوب	Ncs
جنوبی	جنوبی	As
جنین	جنین	Ncs
جوابگوی	جوابگو	Ncs
جواد	جواد	Nas
جوامع	جامعه	Ncl
جوان	جوان	As
جوان	جوان	Nas
جوان	جوان	Ncs
جوانان	جوان	Ncl
جوانترها	جوان	Ncl
جوانه	جوانه	Ncs
جوانی	جوان	Ncs
جوانی	جوانی	Ncs
جواهر	جواهر	Ncs
جواهری	جواهری	Ncs
جوایزی	جایزه	Ncl
جوسازی	جوسازی	Ncs
جوسازیهایی	جوسازی	Ncl
جوشان	جوشان	As
جولیو	جولیو	Nas
جویا	جویا	As
جویندگان	جوینده	Ncl
جهات	جهت	Ncl
جهاد	جهاد	Ncs
جهان	جهان	Ncs
جهانگردان	جهانگرد	Ncl
جهانی	جهانی	As
جهت	جهت	Ez
جهت	جهت	Ncs
جهل	جهل	Ncs
چاپ	چاپ	Ncs
چارچوب	چارچوب	Ncs
چارچوبهایی	چارچوب	Ncl
چارلز	چارلز	Nas
چاقی	چاقی	Ncs
چالشها	چالش	Ncl
چالشهای	چالش	Ncl
چانه	چانه	Ncs
چاه	چاه	Ncs
چتر	چتر	Ncs
چرا	چرا	Dg
چربی	چربی	Ncs
چربیها	چربی	Ncl
چرخ	چرخ	Ncs
چشم	چشم	Ncs
چشمگیری	چشمگیر	As
چشیده	چشیدن,چش,چشید	Vp-
چکیده	چکیدن,چک,چکید	Vp-
چگونگی	چگونگی	Ncs
چگونه	چگونه	Dg
چمدان	چمدان	Ncs
چمدانی	چمدانی	As
چناری	چناری	Nas
چنان	چنان	Dg
چنان	چنان	Di
چنانچه	چنانچه	Jo
چنانکه	چنانکه	J-
چند	چند	As
چند	چند	Tf
چندان	چندان	Di
چندانی	چندان	As
چندروزه	چندروزه	Dg
چندهزارساله	چندهزارساله	As
چنگیز	چنگیز	Nas
چنین	چنین	Di
چنین	چنین	Ls
چنین	چنین	Zfs
چوبی	چوبی	As
چوکا	چوکا	Nas
چوکای	چوکای	Nas
چون	چون	Dg
چون	چون	J-
چهار	چهار	Ur
چهاردهم	چهاردهم	Uo
چهاردهمی	چهاردهمی	As
چهاردهمی	چهاردهمی	Uo
چهاردهمین	چهاردهمین	Uo
چهارشنبه	چهارشنبه	Nas
چهارم	چهارم	Uo
چهارمی	چهارم	Uo
چهارمین	چهارمین	Uo
چهره	چهره	Ncs
چهل	چهل	Ur
چیز	چیز	Ncs
چیزها	چیز	Ncl
چیزهای	چیز	Ncl
چیزهایی	چیز	Ncl
چیزی	چیز	Ncs
چین	چین	Nas
چینی	چینی	As
حاج	حاج	Nas
حادثه	حادثه	Ncs
حاشیه	حاشیه	Ncs
حاصل	حاصل	Ncs
حاصلی	حاصل	Ncs
حاضر	حاضر	As
حاضران	حاضر	Ncl
حافظ	حافظ	Nas
حاکم	حاکم	As
حاکم	حاکم	Ncs
حاکمیت	حاکمیت	Ncs
حاکی	حاکی	As
حال	حال	Dg
حال	حال	Ncs
حالت	حالت	Ncs
حالی	حال	Ncs
حامیان	حامی	Ncl
حاوی	حاوی	As
حائری	حائری	Nas
حبوبات	حبوب	Ncl
حتما	حتما	Dg
حتی	حتی	Dg
حجاریان	حجاریان	Nas
حجتی	حجتی	Nas
حجر	حجر	Nas
حجم	حجم	Ncs
حجی	حج	Ncs
حداقل	حداقل	Dg
حداکثری	حداکثری	As
حدود	حد	Ncl
حدود	حدود	Tf
حدی	حد	Ncs
حذف	حذف	Ncs
حذفی	حذفی	As
حراجی	حراجی	Ncs
حرارت	حرارت	Ncs
حرف	حرف	Ncs
حرفی	حرف	Ncs
حرکت	حرکت	Ncs
حرکتهای	حرکت	Ncl
حرکتی	حرکت	Ncs
حروف	حرف	Ncl
حریر	حریر	Ncs
حریری	حریری	Nas
حریف	حریف	Ncs
حریفان	حریف	Ncl
حریق	حریق	Ncs
حریقی	حریق	Ncs
حزب	حزب	Ncs
حزبی	حزبی	As
حساب	حساب	Ncs
حسابگرانه	حسابگرانه	Dg
حساس	حساس	As
حساسیت	حساسیت	Ncs
حساسیتها	حساسیت	Ncl
حساسیتهای	حساسیت	Ncl
حسب	حسب	Ncs
حسن	حسن	Nas
حسی	حس	Ncs
حسین	حسین	Nas
حشیش	حشیش	Ncs
حضرت	حضرت	Nas
حضرتعالی	حضرتعالی	Zrs
حضور	حضور	Ncs
حضوری	حضور	Ncs
حفاظت	حفاظت	Ncs
حفر	حفر	Ncs
حفظ	حفظ	Ncs
حقا	حقا	Rw
حقایق	حقیقت	Ncl
حقوق	حق	Ncl
حقه	حقه	As
حقی	حق	Ncs
حقیر	حقیر	As
حقیقت	حقیقت	Ncs
حقیقی	حقیقی	As
حکام	حکام	Ncs
حکایت	حکایت	Ncs
حکم	حکم	Nas
حکمفرما	حکمفرما	Ncs
حکومت	حکومت	Ncs
حکومتی	حکومت	Ncs
حله	حله	Ncs
حمام	حمام	Ncs
حمایت	حمایت	Ncs
حمزه	حمزه	Nas
حمل	حمل	Ncs
حملات	حمله	Ncl
حمله	حمله	Ncs
حوادث	حادثه	Ncl
حوادثی	حادثه	Ncl
حوزه	حوزه	Nas
حوزه	حوزه	Ncs
حیات	حیات	Ncs
حیث	حیث	Ncs
حیدریان	حیدریان	Nas
حیرت	حیرت	Ncs
حیطه	حیطه	Ncs
حیوان	حیوان	Ncs
حیوانات	حیوان	Ncl
حیوانی	حیوانی	As
خاتمه	خاتمه	Ncs
خاتمی	خاتمی	Nas
خارج	خارج	Ncs
خارجه	خارجه	As
خارجی	خارجی	As
خاست	خاستن,خیز,خاست	Vpy
خاستگاه	خاستگاه	Ncs
خاص	خاص	As
خاص	خاص	Ncs
خاصی	خاص	As
خاصیت	خاصیت	Ncs
خاطر	خاطر	Ncs
خاطرنشان	خاطرنشان	Ncs
خاطره	خاطره	Ncs
خاک	خاک	Ncs
خالق	خالق	Ncs
خان	خان	Nas
خاندان	خاندان	Ncs
خانم	خانم	Nas
خانمهای	خانم	Ncl
خانواده	خانواده	Ncs
خانه	خانه	Ncs
خاورمیانه	خاورمیانه	Nas
خائنی	خائن	Ncs
خبر	خبر	Ncs
خبرگزاری	خبرگزاری	Ncs
خبرنگار	خبرنگار	Ncs
خبرنگاران	خبرنگار	Ncl
خبره	خبره	As
خبری	خبری	As
ختم	ختم	Ncs
خدا	خدا	Nas
خداوند	خداوند	Nas
خدای	خدای	Nas
خدشه	خدشه	Ncs
خدمات	خدمت	Ncl
خدمت	خدمت	Ncs
خدمه	خادم	Ncl
خرابی	خرابی	Ncs
خراسان	خراسان	Nas
خرد	خرد	Ncs
خرداد	خرداد	Nas
خردسال	خردسال	As
خرس	خرس	Ncs
خروج	خروج	Ncs
خروس	خروس	Ncs
خرید	خرید	Ncs
خریدار	خریدار	Ncs
خریداری	خریداری	Ncs
خزانه	خزانه	Ncs
خزرآباد	خزرآباد	Nas
خزنده	خزنده	As
خساراتی	خسارت	Ncl
خسارت	خسارت	Ncs
خشک	خشک	As
خشکسالی	خشکسالی	Ncs
خشم	خشم	Ncs
خشن	خشن	As
خصوص	خصوص	Ncs
خصوصی	خصوصی	As
خصوصیات	خصوصیه	Ncl
خطا	خطا	Ncs
خطاب	خطاب	Ncs
خطبه	خطبه	Ncs
خطر	خطر	Ncs
خطرناک	خطرناک	As
خطرناکتر	خطرناک	Ac
خطرهای	خطر	Ncl
خطری	خطر	Ncs
خطوط	خط	Ncl
خطه	خطه	Ncs
خطیری	خطیر	As
خلافها	خلاف	Ncl
خلاقیت	خلاقیت	Ncs
خلق	خلق	Ncs
خلیج	خلیج	Ncs
خلیفه	خلیفه	Ncs
خمودی	خمودی	Ncs
خمینی	خمینی	Nas
خواب	خواب	Ncs
خوابهای	خواب	Ncl
خواربار	خواربار	Ncs
خواست	خواست	Ncs
خواست	خواستن,خواه,خواست	Vpy
خواستار	خواستار	As
خواستگاری	خواستگاری	Ncs
خواسته	خواستن,خواه,خواست	Vp-
خواص	خاص	Ncl
خوان	خوان	Nas
خواند	خواندن,خوان,خواند	Vpy
خواندن	خواندن,خوان,خواند	Vp-
خوانده	خواندن,خوان,خواند	Vp-
خواندیم	خواندن,خوان,خواند	Vpy
خوانندگان	خواننده	Ncl
خواهان	خواهان	Ncs
خواهد	خواستن,خواه,خواست	Vpx
خواهر	خواهر	Ncs
خواهم	خواستن,خواه,خواست	Vpx
خواهند	خواستن,خواه,خواست	Vpx
خواهندگان	خواهنده	Ncl
خواهیم	خواستن,خواه,خواست	Vpx
خوب	خوب	As
خوب	خوب	Dg
خوبی	خوب	As
خود	خود	Zx-
خودداری	خودداری	Ncs
خودکار	خودکار	As
خودکشی	خودکشی	Ncs
خوراکی	خوراکی	Ncs
خورد	خوردن,خور,خورد	Vpy
خوردند	خوردن,خور,خورد	Vpy
خوشبختانه	خوشبختانه	Dg
خوشبو	خوشبو	As
خوشبوکننده	خوشبوکننده	As
خوشبین	خوشبین	As
خوشفکر	خوشفکر	As
خوشمزه	خوشمزه	As
خوشی	خوش	As
خون	خون	Ncs
خونرسانی	خونرسانی	Ncs
خونی	خون	Ncs
خونی	خونی	As
خونین	خونین	As
خویش	خویش	Zx-
خیابان	خیابان	Ncs
خیال	خیال	Ncs
خیر	خیر	Rp
خیراندیش	خیراندیش	As
خیرخواه	خیرخواه	As
خیرخواهان	خیرخواه	Ncl
خیلی	خیلی	Di
خیمه	خیمه	Ncs
داخل	داخل	Ez
داخل	داخل	Ncs
داخلی	داخلی	As
داد	دادن,ده,داد	Vpy
دادرسی	دادرسی	Ncs
دادستان	دادستان	Ncs
دادگاه	دادگاه	Ncs
دادگستری	دادگستری	Ncs
دادن	دادن,ده,داد	Vp-
دادند	دادن,ده,داد	Vpy
دادوستد	دادوستد	Ncs
داده	دادن,ده,داد	Vp-
دارا	دارا	As
دارای	دارا	As
دارد	داشتن,دار,داشت	Vpx
دارد	داشتن,دار,داشت	Vpy
دارم	داشتن,دار,داشت	Vpy
دارند	داشتن,دار,داشت	Vpy
دارو	دارو	Ncs
داروهای	دارو	Ncl
داروی	دارو	Ncs
دارویی	دارویی	As
دارید	داشتن,دار,داشت	Vpy
داریم	داشتن,دار,داشت	Vpy
داریوش	داریوش	Nas
داستان	داستان	Ncs
داستایوفسکی	داستایوفسکی	Nas
داسی	داس	Ncs
داشت	داشتن,دار,داشت	Vpy
داشتن	داشتن,دار,داشت	Vp-
داشتند	داشتن,دار,داشت	Vpy
داشته	داشتن,دار,داشت	Vp-
داشتی	داشتن,دار,داشت	Vpy
داشتیم	داشتن,دار,داشت	Vpy
داغترین	داغ	Au
دال	دال	Ncs
داماد	داماد	Nas
داماد	داماد	Ncs
دامن	دامن	Ncs
دامنه	دامنه	Ncs
دان	دان	Ce
دانجا	دانجا	Ce
دانستن	دانستن,دان,دانست	Vp-
دانستند	دانستن,دان,دانست	Vpy
دانش	دانش	Ncs
دانشجویان	دانشجو	Ncl
دانشکده	دانشکده	Ncs
دانشگاه	دانشگاه	Ncs
دانشگاههای	دانشگاه	Ncl
دانشمندان	دانشمند	Ncl
دانشوران	دانشور	Ncl
داوران	داور	Ncl
داوری	داوری	Ncs
داوطلبانه	داوطلبانه	As
داوین	داوین	Nas
دائم	دائم	As
دائمی	دائمی	As
دبیر	دبیر	Ncs
دچار	دچار	As
دخالت	دخالت	Ncs
دخانیات	دخانیه	Ncl
دختر	دختر	Ncs
دختران	دختر	Ncl
دراز	دراز	As
درازمدت	درازمدت	As
درازمدت	درازمدت	Dg
درایت	درایت	Ncs
درآمد	درآمد	Ncs
درآمدی	درآمد	Ncs
درب	درب	Ncs
درباره	درباره	Ez
دربرگیرنده	دربرگیرنده	As
درج	درج	Ncs
درجه	درجه	Ncs
درختان	درخت	Ncl
درخشان	درخشان	As
درخشانی	درخشان	As
درخواست	درخواست	Ncs
درخور	درخور	As
درد	درد	Ncs
درس	درس	Ncs
درست	درست	Dg
درصد	درصد	Ls
درصد	درصد	Ncs
درصدی	درصدی	Rj
درک	درک	Ncs
درگاه	درگاه	Ncs
درگذشت	درگذشت	Ncs
درمان	درمان	Ncs
درمانی	درمان	Ncs
درمانی	درمانی	As
درواقع	درواقع	Dg
دروس	درس	Ncl
دروغ	دروغ	As
دروغ	دروغ	Ncs
دروغین	دروغین	As
درون	درون	Ncs
درونی	درونی	As
درهای	در	Ncl
درهم	درهم	Nas
دریافت	دریافت	Ncs
دریافتی	دریافتی	As
دریای	دریا	Ncs
دریغ	دریغ	Dg
دست	دست	Ncs
دستان	دست	Ncl
دستاوردهای	دستاورد	Ncl
دستاویزی	دستاویز	Ncs
دسترس	دسترس	Ncs
دسترسی	دسترسی	Ncs
دستکاری	دستکاری	Ncs
دستگاه	دستگاه	Ncs
دستگیر	دستگیر	As
دستگیری	دستگیری	Ncs
دستمایه	دستمایه	Ncs
دستور	دستور	Ncs
دستوری	دستوری	As
دسته	دسته	Ncs
دستها	دست	Ncl
دستهای	دست	Ncl
دستی	دستی	As
دستیابی	دستیابی	Ncs
دستیاران	دستیار	Ncl
دشت	دشت	Ncs
دشمن	دشمن	Ncs
دشمنان	دشمن	Ncl
دشمنی	دشمنی	Ncs
دشوار	دشوار	As
دعاها	دعا	Ncl
دعوت	دعوت	Ncs
دغدغه	دغدغه	Ncs
دفاع	دفاع	Ncs
دفتر	دفتر	Ncs
دفرماسیون	دفرماسیون	Ncs
دفع	دفع	Ncs
دفن	دفن	Ncs
دقت	دقت	Ncs
دقیق	دقیق	As
دقیقه	دقیقه	Ncs
دکتر	دکتر	Nas
دگرگون	دگرگون	As
دگرگونی	دگرگونی	Ncs
دلار	دلار	Nas
دلاری	دلاری	Rj
دلال	دلال	Ncs
دلالت	دلالت	Ncs
دلایل	دلیل	Ncl
دلایلی	دلیل	Ncl
دلفان	دلفان	Nas
دلنشین	دلنشین	As
دلهای	دل	Ncl
دلیل	دلیل	Ncs
دلیلی	دلیل	Ncs
دماوند	دماوند	Nas
دمشق	دمشق	Nas
دمکرات	دمکرات	As
دموکراتیک	دموکراتیک	As
دموکراسی	دموکراسی	Ncs
دمیدن	دمیدن	Ncs
دمیده	دمیدن,دم,دمید	Vp-
دنبال	دنبال	Ncs
دندان	دندان	Ncs
دندانپزشک	دندانپزشک	Ncs
دنیا	دنیا	Ncs
دنیای	دنیا	Ncs
دنیایی	دنیا	Ncs
دنیس	دنیس	Nas
دوباره	دوباره	Dg
دوپاردیو	دوپاردیو	Nas
دوپاماین	دوپاماین	Nas
دوحه	دوحه	Nas
دور	دور	As
دور	دور	Ncs
دوران	دوران	Ncs
دوراندیش	دوراندیش	As
دوراهی	دوراهی	Ncs
دوره	دوره	Ncs
دوست	دوست	Ncs
دوستان	دوست	Ncl
دوستدار	دوستدار	Ncs
دوستداران	دوستدار	Ncs
دوسکور	دوسکور	Nas
دوش	دوش	Ncs
دوشنبه	دوشنبه	Nas
دوفوریت	دوفوریت	Ncs
دوفوریتی	دوفوریتی	As
دوقلو	دوقلو	As
دولت	دولت	Ncs
دولتمردان	دولتمرد	Ncl
دولتهای	دولت	Ncl
دولتی	دولتی	As
دوم	دوم	Uo
دومین	دومین	Uo
دونفره	دونفره	As
دویده	دویدن,دو,دوید	Vp-
دهان	دهان	Ncs
دهد	دادن,ده,داد	Vpy
دهشتناک	دهشتناک	As
دهکده	دهکده	Ncs
دهل	دهل	Ncs
دهمی	دهم	Uo
دهند	دادن,ده,داد	Vpy
دهه	دهه	Ncs
دهها	ده	Ur
دیابت	دیابت	Ncs
دیابتی	دیابتی	As
دیار	دیار	Ncs
دیجیتالی	دیجیتال	As
دید	دید	Ncs
دیدار	دیدار	Ncs
دیدارهای	دیدار	Ncl
دیدگاه	دیدگاه	Ncs
دیدگاهها	دیدگاه	Ncl
دیدگاههای	دیدگاه	Ncl
دیدگاهی	دیدگاه	Ncs
دیدن	دیدن,بین,دید	Vp-
دیده	دیدن,بین,دید	Vp-
دیروز	دیروز	Dg
دیگر	دیگر	As
دیگر	دیگر	Dg
دیگر	دیگر	Zfs
دیگران	دیگران	Zfl
دیگری	دیگر	Zfs
دیگری	دیگری	Zfs
دین	دین	Ce
دین	دین	Ncs
دینار	دینار	Nas
دینداران	دیندار	Ncl
دینی	دین	Ncs
دینی	دینی	As
ذخایر	ذخیره	Ncl
ذرت	ذرت	Ncs
ذکر	ذکر	Ncs
ذکرشده	ذکرشده	As
ذوق	ذوق	Ncs
ذهن	ذهن	Ncs
ذهنیت	ذهنیت	Ncs
ذیربط	ذیربط	As
ذیل	ذیل	As
رابطه	رابطه	Ncs
راحت	راحت	As
راحل	راحل	As
رادیو	رادیو	Ncs
رادیویی	رادیویی	As
راز	راز	Ncs
رازقندی	رازقندی	Nas
راست	راست	As
راستی	راستی	Nas
رامشگر	رامشگر	Nas
راندن	راندن,ران,راند	Vp-
رانده	راندن,ران,راند	Vp-
راه	راه	Ncs
راهبرد	راهبرد	Ncs
راهبردهای	راهبرد	Ncl
راهبردی	راهبردی	As
راهپیمایی	راهپیمایی	Ncs
راهنمای	راهنما	Ncs
راههای	راه	Ncl
راهی	راه	Ncs
راهی	راهی	Ncs
رای	رای	Ncs
رای	رای	Ncs
رأی	رأی	Ncs
رایج	رایج	As
رایگان	رایگان	As
رجوع	رجوع	Ncs
رده	رده	Ncs
ردیابی	ردیابی	Ncs
ردیف	ردیف	Ncs
رژیم	رژیم	Ncs
رژیمهای	رژیم	Ncl
رسالت	رسالت	Nas
رسالت	رسالت	Ncs
رساند	رساندن,رسان,رساند	Vpy
رساندن	رساندن,رسان,رساند	Vp-
رساندند	رساندن,رسان,رساند	Vpy
رسای	رسا	As
رستوران	رستوران	Ncs
رسمی	رسمی	As
رسمیت	رسمیت	Ncs
رسوا	رسوا	As
رسوم	رسم	Ncl
رسید	رسیدن,رس,رسید	Vpy
رسیدگی	رسیدگی	Ncs
رسیدن	رسیدن,رس,رسید	Vp-
رسیدند	رسیدن,رس,رسید	Vpy
رسیده	رسیدن,رس,رسید	Vp-
رسیده	رسیده	As
رشته	رشته	Ncs
رشد	رشد	Ncs
رشوه	رشوه	Ncs
رضا	رضا	Nas
رضایت	رضایت	Ncs
رضایی	رضایی	Nas
رعایت	رعایت	Ncs
رغم	رغم	Ncs
رفت	رفت	Ncs
رفت	رفتن,رو,رفت	Vpy
رفتار	رفتار	Ncs
رفتارها	رفتار	Ncl
رفتارهای	رفتار	Ncl
رفتاری	رفتار	Ncs
رفتاری	رفتاری	As
رفتن	رفتن,رو,رفت	Vp-
رفتند	رفتن,رو,رفت	Vpy
رفع	رفع	Ncs
رفیق	رفیق	Nas
رقابت	رقابت	Ncs
رقابتها	رقابت	Ncl
رقابتهای	رقابت	Ncl
رقابتی	رقابتی	As
رقم	رقم	Ncs
رقیب	رقیب	As
رکن	رکن	Ncs
رکود	رکود	Ncs
رکوردهای	رکورد	Ncl
رگهای	رگ	Ncl
رمضان	رمضان	Nas
رمضانی	رمضانی	Nas
رمیده	رمیدن,رم,رمید	Vp-
رنج	رنج	Ncs
رنگ	رنگ	Ncs
رنگهای	رنگ	Ncl
روا	روا	As
روابط	رابطه	Ncl
رواج	رواج	Ncs
رواک	رواک	Nas
روال	روال	Ncs
روانشناس	روانشناس	Ncs
روانی	روانی	As
روایت	روایت	Ncs
روبات	روبات	Ncs
روبرو	روبرو	Ncs
روبناها	روبنا	Ncl
روبین	روبین	Nas
روح	روح	Ncs
روحانی	روحانی	As
روحانیت	روحانیت	Ncs
روحانیون	روحان	Ncl
روحانیها	روحانی	Ncl
روحی	روح	Ncs
رود	رفتن,رو,رفت	Vpy
روده	روده	Nas
روده	روده	Ncs
رور	رور	Nas
روز	روز	Ncs
روزانه	روزانه	Dg
روزگار	روزگار	Ncs
روزمره	روزمره	As
روزنامه	روزنامه	Ncs
روزه	روزه	Ncs
روزها	روز	Ncl
روزهای	روز	Ncl
روزی	روز	Ncs
روستا	روستا	Ncs
روستاها	روستا	Ncl
روستایی	روستایی	As
روسو	روسو	Nas
روش	روش	Ncs
روشن	روشن	As
روشنفکران	روشنفکر	Ncl
روشنفکرنمایان	روشنفکرنما	Ncl
روشنگری	روشنگری	Ncs
روشنی	روشن	As
روشهای	روش	Ncl
روشهایی	روش	Ncl
روشی	روش	Ncs
روم	روم	Nas
رومه	رومه	Nas
روند	روند	Ncs
رونق	رونق	Ncs
روی	رو	Ncs
روی	روی	Ez
روی	روی	Ncs
رویا	رویا	Ncs
رویابافیهای	رویابافی	Ncl
رویایی	رویایی	As
رویکرد	رویکرد	Ncs
رها	رها	As
رهایی	رهایی	Ncs
رهبر	رهبر	Ncs
رهبری	رهبری	Ncs
رهسپار	رهسپار	Ncs
رهنمایی	رهنمایی	Ncs
ریاست	ریاست	Ncs
ریال	ریال	Nas
ریختی	ریختی	As
ریزش	ریزش	Ncs
ریش	ریش	Ncs
ریشه	ریشه	Ncs
رینگ	رینگ	Ncs
رینو	رینو	Nas
ریوی	ریوی	As
ریه	ریه	Ncs
رییس	رییس	Ncs
رئیس	رئیس	Ncs
رئیسه	رئیسه	As
زابورو	زابورو	Nas
زانو	زانو	Ncs
زاویه	زاویه	Ncs
زاهدان	زاهدان	Nas
زایمان	زایمان	Ncs
زائد	زائد	As
زائر	زائر	Ncs
زباله	زباله	Ncs
زبان	زبان	Ncs
زبانزد	زبانزد	Ncs
زبر	زبر	As
زبرو	زبرو	Nas
زحمت	زحمت	Ncs
زخم	زخم	Ncs
زخمها	زخم	Ncl
زدن	زدن,زن,زد	Vp-
زدند	زدن,زن,زد	Vpy
زده	زدن,زن,زد	Vp-
زرین	زرین	As
زشت	زشت	As
زکات	زکات	Ncs
زلزله	زلزله	Ncs
زمان	زمان	Nas
زمان	زمان	Ncs
زمانها	زمان	Ncl
زمانی	زمان	Ncs
زمزمه	زمزمه	Ncs
زمین	زمین	Ncs
زمینه	زمینه	Ncs
زنان	زن	Ncl
زنانه	زنانه	As
زنانی	زن	Ncl
زنجیرشده	زنجیرشده	As
زندان	زندان	Ncs
زندانی	زندانی	Ncs
زندانیان	زندان	Ncl
زندگانی	زندگانی	Ncs
زندگی	زندگی	Ncs
زنده	زنده	As
زنگ	زنگ	Ncs
زوال	زوال	Ncs
زودتر	زودتر	Dg
زودرس	زودرس	As
زودگذر	زودگذر	As
زودهضمی	زودهضمی	Ncs
زور	زور	Ncs
زهد	زهد	Ncs
زهی	زهی	Ru
زهیر	زهیر	Nas
زیاد	زیاد	As
زیاد	زیاد	Nas
زیادتر	زیاد	Ac
زیادی	زیاد	As
زیارتگاه	زیارتگاه	Ncs
زیارتی	زیارت	Ncs
زیبا	زیبا	As
زیباتر	زیبا	Ac
زیباشناختی	زیباشناختی	As
زیبای	زیبا	As
زیبایی	زیبایی	Ncs
زیباییهای	زیبایی	Ncl
زید	زید	Nas
زیر	زیر	As
زیر	زیر	Ez
زیر	زیر	Ncs
زیرا	زیرا	J-
زیربنای	زیربنا	Ncs
زین	زین	Ncs
زینب	زینب	Nas
زینتی	زینتی	As
ژاپن	ژاپن	Nas
ژان	ژان	Nas
ژانگ	ژانگ	Nas
ژرار	ژرار	Nas
ژرفنگر	ژرفنگر	As
ژلاتین	ژلاتین	Ncs
ژنتیک	ژنتیک	As
ژوسپن	ژوسپن	Nas
ژوئن	ژوئن	Nas
سابق	سابق	As
سابقه	سابقه	Ncs
ساحل	ساحل	Ncs
ساخت	ساخت	Ncs
ساخت	ساختن,ساز,ساخت	Vpy
ساختن	ساختن,ساز,ساخت	Vp-
ساختند	ساختن,ساز,ساخت	Vpy
ساخته	ساختن,ساز,ساخت	Vp-
ساخته	ساخته	As
ساخته	ساخته	Ncs
ساده	ساده	As
ساری	ساری	Nas
ساز	ساز	Ncs
سازد	ساختن,ساز,ساخت	Vpy
سازمان	سازمان	Ncs
سازمانهای	سازمان	Ncl
سازمانی	سازمان	Ncs
سازند	ساختن,ساز,ساخت	Vpy
سازندگی	سازندگی	Ncs
سازنده	سازنده	As
ساعات	ساعت	Ncl
ساعت	ساعت	Ncs
ساقه	ساقه	Ncs
سال	سال	Ncs
سالانه	سالانه	Dg
سالمند	سالمند	As
سالمند	سالمند	Ncs
سالمونلا	سالمونلا	Nas
سالن	سالن	Ncs
سالنهای	سالن	Ncl
ساله	ساله	Rj
سالها	سال	Ncl
سالهای	سال	Ncl
سالی	سال	Ncs
ساموئل	ساموئل	Nas
سانتیمتر	سانتیمتر	Ncs
ساوایانو	ساوایانو	Nas
ساوجی	ساوجی	Nas
سایپا	سایپا	Nas
سایر	سایر	Ncs
سایران	سایر	Ncl
سایه	سایه	Ncs
سبب	سبب	Ncs
سبز	سبز	As
سبزها	سبز	Nal
سبزیها	سبزی	Ncl
سبک	سبک	As
سبکی	سبک	Ncs
سبیل	سبیل	Ncs
سپاهان	سپاهان	Nas
سپرده	سپردن,سپر,سپرد	Vp-
سپس	سپس	J-
سپنتا	سپنتا	Nas
سپیده	سپیده	Ncs
ستاد	ستاد	Ncs
ستادها	ستاد	Ncl
ستادهای	ستاد	Ncl
ستایشی	ستایشی	As
ستم	ستم	Ncs
ستمها	ستم	Ncl
ستونهای	ستون	Ncl
سحر	سحر	Ncs
سحرانگیز	سحرانگیز	As
سخت	سخت	As
سختی	سختی	Ncs
سخن	سخن	Ncs
سخنان	سخن	Ncl
سخنرانی	سخنرانی	Ncs
سخنرانیها	سخنرانی	Ncl
سخنگوی	سخنگو	Ncs
سخنی	سخن	Ncs
سراسر	سراسر	Ncs
سراسیمه	سراسیمه	Dg
سران	سر	Ncl
سرانجام	سرانجام	Dg
سرای	سرا	Ncs
سرایت	سرایت	Ncs
سرباز	سرباز	Ncs
سربازان	سرباز	Ncl
سربند	سربند	Nas
سربینه	سربینه	Ncs
سرپیچی	سرپیچی	Ncs
سرخ	سرخ	As
سرخس	سرخس	Nas
سردرد	سردرد	Ncs
سردردهای	سردرد	Ncl
سردردهایی	سردرد	Ncl
سردمداران	سردمدار	Ncl
سرزمین	سرزمین	Ncs
سرزمینها	سرزمین	Ncl
سرزمینهای	سرزمین	Ncl
سرزمینی	سرزمین	Ncs
سرشار	سرشار	As
سرشت	سرشت	Ncs
سرشناس	سرشناس	As
سرطان	سرطان	Ncs
سرطانهای	سرطان	Ncl
سرطانی	سرطانی	As
سرعت	سرعت	Ncs
سرفه	سرفه	Ncs
سرکرده	سرکرده	Ncs
سرکوب	سرکوب	Ncs
سرگیجه	سرگیجه	Ncs
سرماخوردگی	سرماخوردگی	Ncs
سرمای	سرما	Ncs
سرمایه	سرمایه	Ncs
سرمقاله	سرمقاله	Ncs
سرنگ	سرنگ	Ncs
سرنوشت	سرنوشت	Ncs
سرنیزه	سرنیزه	Ncs
سرودهای	سرود	Ncl
سروکار	سروکار	Ncs
سرویسهای	سرویس	Ncl
سرهای	سر	Ncl
سری	سری	Ls
سریالهای	سریال	Ncl
سریع	سریع	Dg
سست	سست	As
سطح	سطح	Ncs
سطوح	سطح	Ncl
سعدی	سعدی	Nas
سعودی	سعودی	Nas
سعه	سعه	Ncs
سعی	سعی	Ncs
سعید	سعید	Nas
سفارش	سفارش	Ncs
سفر	سفر	Ncs
سفرای	سفیر	Ncl
سفرهای	سفر	Ncl
سفید	سفید	As
سفیدپوست	سفیدپوست	As
سقط	سقط	Ncs
سقفها	سقف	Ncl
سقم	سقم	Ncs
سقوط	سقوط	Ncs
سقوطهای	سقوط	Ncl
سکته	سکته	Ncs
سکوت	سکوت	Ncs
سکه	سکه	Ncs
سلاحهای	سلاح	Ncl
سلاحی	سلاح	Ncs
سلامت	سلامت	Ncs
سلامتی	سلامتی	Ncs
سلب	سلب	Ncs
سلسله	سلسله	Ncs
سلطان	سلطان	Ncs
سلطنت	سلطنت	Ncs
سلطه	سلطه	Ncs
سلولها	سلول	Ncl
سلولهای	سلول	Ncl
سمبلی	سمبل	Ncs
سمت	سمت	Ncs
سموم	سم	Ncl
سمهای	سم	Ncl
سمیرا	سمیرا	Nas
سمینار	سمینار	Ncs
سنا	سنا	Nas
سناتور	سناتور	Nas
سناتور	سناتور	Ncs
سناتورها	سناتور	Ncl
سنای	سنای	Nas
سنت	سنت	Ncs
سنتها	سنت	Ncl
سنتهای	سنت	Ncl
سنتی	سنتی	As
سندی	سند	Ncs
سنگ	سنگ	Ncs
سنگاپور	سنگاپور	Nas
سنگر	سنگر	Ncs
سنگهای	سنگ	Ncl
سنگی	سنگی	As
سنگین	سنگین	As
سنین	سن	Ncl
سوء	سوء	Ncs
سوءاستفاده	سوءاستفاده	Ncs
سوءتغذیه	سوءتغذیه	Ncs
سوءظنی	سوءظن	Ncs
سوءقصد	سوءقصد	Ncs
سوار	سوار	Ncs
سواران	سوار	Ncl
سواره	سواره	As
سود	سود	Ncs
سودان	سودان	Nas
سودی	سود	Ncs
سوزاندن	سوزاندن,سوزان,سوزاند	Vp-
سوم	سوم	Uo
سومین	سومین	Uo
سونیا	سونیا	Nas
سوی	سو	Ncs
سهام	سهم	Ncl
سهم	سهم	Ncs
سهولت	سهولت	Ncs
سؤال	سؤال	Ncs
سؤالات	سؤال	Ncl
سیا	سیا	Nas
سیاحتی	سیاحتی	As
سیار	سیار	As
سیاست	سیاست	Ncs
سیاستمدار	سیاستمدار	Ncs
سیاستمداران	سیاستمدار	Ncl
سیاستهای	سیاست	Ncl
سیاسی	سیاسی	As
سیاه	سیاه	As
سیاهه	سیاهه	Ncs
سید	سید	Nas
سیدالشهداء	سیدالشهداء	Nas
سیدنی	سیدنی	Nas
سیر	سیر	Ncs
سیراب	سیراب	As
سیزدهمین	سیزدهمین	Uo
سیستم	سیستم	Ncs
سیسیل	سیسیل	Nas
سیف	سیف	Nas
سیفلیسی	سیفلیس	As
سیگار	سیگار	Ncs
سیل	سیل	Ncs
سیلندری	سیلندری	As
سیلندری	سیلندری	Ncs
سیما	سیما	Ncs
سینماهای	سینما	Ncl
سینمای	سینما	Ncs
سینمایی	سینمایی	As
سینه	سینه	Ncs
سئوال	سئوال	Ncs
سئوالات	سئوال	Ncl
شاخص	شاخص	As
شاخص	شاخص	Ncs
شاد	شاد	As
شازند	شازند	Nas
شاعر	شاعر	Ncs
شاعری	شاعر	Ncs
شاعری	شاعری	As
شاغل	شاغل	As
شافعی	شافعی	Nas
شام	شام	Nas
شام	شام	Ncs
شامگاه	شامگاه	Ncs
شامل	شامل	As
شان	شان	Ce
شأن	شأن	Ncs
شانزده	شانزده	Ur
شاه	شاه	Nas
شاهد	شاهد	Ncs
شاهکار	شاهکار	Ncs
شاید	شاید	Dg
شایسته	شایسته	As
شایعات	شایعه	Ncl
شایعترین	شایع	Au
شباهت	شباهت	Ncs
شبکه	شبکه	Ncs
شبنم	شبنم	Ncs
شبنمی	شبنم	Ncs
شبی	شب	Ncs
شبیه	شبیه	As
شتاب	شتاب	Ncs
شتابزدگی	شتابزدگی	Ncs
شتابزده	شتابزده	As
شتر	شتر	Ncs
شجاعی	شجاعی	Nas
شجریان	شجریان	Nas
شخص	شخص	Ncs
شخصا	شخصا	Dg
شخصی	شخصی	As
شخصیتها	شخصیت	Ncl
شخصیتهای	شخصیت	Ncl
شدت	شدت	Ncs
شدن	شدن,شو,شد	Vp-
شدند	شدن,شو,شد	Vpy
شده	شدن,شو,شد	Vp-
شدید	شدید	As
شدیدا	شدیدا	Di
شدیدتر	شدید	Ac
شدیدی	شدید	As
شدیم	شدن,شو,شد	Vpy
شراب	شراب	Ncs
شرارتهای	شرارت	Ncl
شرایط	شرط	Ncl
شرایطی	شرط	Ncl
شربت	شربت	Ncs
شربتها	شربت	Ncl
شرح	شرح	Ncs
شرقی	شرقی	As
شرکت	شرکت	Ncs
شرکتها	شرکت	Ncl
شرکتهای	شرکت	Ncl
شروع	شروع	Ncs
شریف	شریف	As
شریف	شریف	Nas
ششصد	ششصد	Ur
ششم	ششم	Uo
شصت	شصت	Ur
شطرنج	شطرنج	Ncs
شعار	شعار	Ncs
شعارگرایی	شعارگرایی	Ncs
شعارهای	شعار	Ncl
شعبه	شعبه	Ncs
شغل	شغل	Ncs
شفاف	شفاف	As
شفافیت	شفافیت	Ncs
شکاف	شکاف	Ncs
شکایت	شکایت	Ncs
شکایتهای	شکایت	Ncl
شکر	شکر	Ncs
شکست	شکست	Ncs
شکستن	شکستن,شکن,شکست	Vp-
شکل	شکل	Ncs
شکلهای	شکل	Ncl
شکلی	شکل	Ncs
شکم	شکم	Ncs
شکوهمند	شکوهمند	As
شگفتی	شگفتی	Ncs
شما	شما	Zrl
شمار	شمار	Ncs
شماری	شمار	Ncs
شمال	شمال	Ncs
شمالی	شمالی	As
شمرد	شمردن,شمر,شمرد	Vpy
شمسی	شمسی	As
شمشیر	شمشیر	Ncs
شناخت	شناخت	Ncs
شناختن	شناختن,شناس,شناخت	Vp-
شناخته	شناختن,شناس,شناخت	Vp-
شناسایی	شناسایی	Ncs
شناسند	شناختن,شناس,شناخت	Vpy
شنبه	شنبه	Nas
شنوایی	شنوایی	Ncs
شنیدن	شنیدن,شنو,شنید	Vp-
شنیده	شنیدن,شنو,شنید	Vp-
شود	شدن,شو,شد	Vpy
شور	شور	Ncs
شوراهای	شورا	Ncl
شورای	شورا	Ncs
شولتز	شولتز	Nas
شوم	شوم	As
شوند	شدن,شو,شد	Vpy
شوهای	شو	Ncl
شهادت	شهادت	Ncs
شهدای	شهید	Ncl
شهر	شهر	Ncs
شهرت	شهرت	Ncs
شهرداری	شهرداری	Nas
شهرداری	شهرداری	Ncs
شهرستان	شهرستان	Ncs
شهرستانها	شهرستان	Ncl
شهرستانهای	شهرستان	Ncl
شهرها	شهر	Ncl
شهرهای	شهر	Ncl
شهری	شهر	Ncs
شهری	شهری	As
شهریور	شهریور	Nas
شهید	شهید	Nas
شیاطین	شیطان	Ncl
شیخ	شیخ	Nas
شیر	شیر	Ncs
شیربها	شیربها	Ncs
شیردهی	شیردهی	Ncs
شیرینی	شیرینی	Ncs
شیطان	شیطان	Nas
شیطانی	شیطانی	As
شیعه	شیعه	Ncs
شیعیان	شیعه	Ncl
شیمیایی	شیمیایی	As
شین	شین	Nas
شیوع	شیوع	Ncs
شیوه	شیوه	Ncs
صاحب	صاحب	Ncs
صاحبان	صاحب	Ncl
صادر	صادر	As
صادرات	صادر	Ncl
صادراتی	صادراتی	As
صاف	صاف	As
صبا	صبا	Nas
صبح	صبح	Ncs
صبحگاه	صبحگاه	Ncs
صبر	صبر	Ncs
صحبت	صحبت	Ncs
صحت	صحت	Ncs
صحنه	صحنه	Ncs
صخره	صخره	Ncs
صدا	صدا	Ncs
صداقت	صداقت	Ncs
صدد	صدد	Ncs
صدر	صدر	Nas
صدر	صدر	Ncs
صدم	صدم	Uo
صدمات	صدمه	Ncl
صدور	صدور	Ncs
صدها	صد	Ur
صدیقی	صدیقی	Nas
صراحت	صراحت	Ncs
صرف	صرف	As
صعود	صعود	Ncs
صفحه	صفحه	Ncs
صفر	صفر	Ur
صفوف	صف	Ncl
صفویه	صفویه	Nas
صلاح	صلاح	Ncs
صلاحدید	صلاحدید	Ncs
صلح	صلح	Ncs
صنایع	صنیع	Ncl
صندوقها	صندوق	Ncl
صنع	صنع	Ncs
صنعت	صنعت	Ncs
صنعتی	صنعتی	As
صنعتی	صنعتی	Nas
صنفی	صنفی	As
صنوفی	صنف	Ncl
صوتی	صوتی	As
صورت	صورت	Ncs
صورتی	صورت	Ncs
صهیونیستها	صهیونیست	Nal
صهیونیستی	صهیونیستی	As
صیانت	صیانت	Ncs
صیغه	صیغه	Ncs
ضبط	ضبط	Ncs
ضدانقلاب	ضدانقلاب	Ncs
ضدانقلابی	ضدانقلابی	As
ضددینی	ضددینی	As
ضدسرطانی	ضدسرطانی	As
ضدمیگرن	ضدمیگرن	As
ضربات	ضربه	Ncl
ضربه	ضربه	Ncs
ضرر	ضرر	Ncs
ضرورت	ضرورت	Ncs
ضروری	ضروری	As
ضریب	ضریب	Ncs
ضعیف	ضعیف	As
ضمن	ضمن	Ez
ضمن	ضمن	Ncs
ضمیمه	ضمیمه	As
ضوابط	ضابطه	Ncl
طاق	طاق	Ncs
طایفه	طایفه	Ncs
طباطبایی	طباطبایی	Nas
طبع	طبع	Ncs
طبق	طبق	Ncs
طبقات	طبقه	Ncl
طبقه	طبقه	Ncs
طبیعت	طبیعت	Ncs
طبیعتا	طبیعتا	Dg
طبیعی	طبیعی	As
طراح	طراح	Ncs
طراحان	طراح	Ncl
طراحی	طراحی	Ncs
طراوت	طراوت	Ncs
طرح	طرح	Ncs
طرحها	طرح	Ncl
طرحهای	طرح	Ncl
طرحی	طرح	Ncs
طرف	طرف	Ncs
طرفدار	طرفدار	Ncs
طریق	طریق	Ncs
طریقه	طریقه	Ncs
طعن	طعن	Ncs
طلا	طلا	Ncs
طلاب	طلبه	Ncl
طلای	طلا	Ncs
طلایی	طلایی	As
طمأنینه	طمأنینه	Ncs
طنز	طنز	Ncs
طنزآمیز	طنزآمیز	As
طواغیت	طاغوت	Ncl
طور	طور	Ncs
طوس	طوس	Nas
طول	طول	Ncs
طولانی	طولانی	As
طهماسبی	طهماسبی	Nas
طیف	طیف	Ncs
ظاهر	ظاهر	Ncs
ظاهرا	ظاهرا	Dg
ظرافت	ظرافت	Ncs
ظرف	ظرف	Ncs
ظرفهای	ظرف	Ncl
ظرفیت	ظرفیت	Ncs
ظریف	ظریف	As
ظهور	ظهور	Ncs
عاجز	عاجز	As
عادات	عادت	Ncl
عادتی	عادتی	As
عادلانه	عادلانه	As
عادی	عادی	As
عارضه	عارضه	Ncs
عارفانه	عارفانه	As
عاری	عاری	As
عاشقانه	عاشقانه	As
عالمی	عالم	Ncs
عالی	عالی	As
عام	عام	Ncs
عامل	عامل	Ncs
عاملان	عامل	Ncl
عبادت	عبادت	Ncs
عبارات	عبارت	Ncl
عبارت	عبارت	Ncs
عبارتی	عبارت	Ncs
عباس	عباس	Nas
عبدالحسین	عبدالحسین	Nas
عبدالله	عبدالله	Nas
عبداللهی	عبداللهی	Nas
عبدالواحد	عبدالواحد	Nas
عبور	عبور	Ncs
عجیب	عجیب	As
عدالت	عدالت	Ncs
عدس	عدس	Ncs
عدم	عدم	Ncs
عده	عده	Ncs
عدی	عدی	Nas
عراق	عراق	Nas
عرب	عرب	Nas
عربستان	عربستان	Nas
عربی	عربی	As
عرش	عرش	Ncs
عرصه	عرصه	Ncs
عرض	عرض	Ncs
عرضه	عرضه	Ncs
عروس	عروس	Ncs
عروسی	عروسی	Ncs
عروق	عرق	Ncl
عروق	عروق	Ncs
عروقی	عرق	Ncs
عروقی	عروقی	As
عزیز	عزیز	As
عسکری	عسکری	Nas
عسل	عسل	Ncs
عشرت	عشرت	Ncs
عشق	عشق	Ncs
عصبانیت	عصبانیت	Ncs
عصبی	عصبی	As
عصر	عصر	Ncs
عضدی	عضدی	Nas
عضو	عضو	Ncs
عضوی	عضو	Ncs
عضویت	عضویت	Ncs
عطاءالله	عطاءالله	Nas
عطر	عطر	Ncs
عطف	عطف	Ncs
عطفی	عطف	Ncs
عظام	عظام	As
عظمت	عظمت	Ncs
عظیم	عظیم	As
عفونت	عفونت	Ncs
عفونتهای	عفونت	Ncl
عقاید	عقیده	Ncl
عقب	عقب	Dg
عقل	عقل	Ncs
عقلای	عقل	Ncl
عقیده	عقیده	Ncs
عقیق	عقیق	Nas
عکس	عکس	Ncs
علاقمندان	علاقمند	Ncl
علاقه	علاقه	Ncs
علامتی	علامت	Ncs
علامه	علامه	Nas
علاوه	علاوه	Ncs
علایم	علامت	Ncl
علایمی	علامت	Ncl
علائم	علامت	Ncl
علائمی	علامت	Ncl
علت	علت	Ncs
علم	علم	Ncs
علما	عالم	Ncl
علمی	علم	Ncs
علمی	علمی	As
علمیه	علمیه	As
علنی	علنی	As
علوم	علم	Ncl
علی	علی	Nas
علینا	علینا	Rw
علیه	علیه	Ez
عمامه	عمامه	Ncs
عمدتا	عمدتا	Dg
عمده	عمده	As
عمده	عمده	Tf
عمر	عمر	Ncs
عمق	عمق	Ncs
عمل	عمل	Ncs
عملا	عملا	Dg
عملکرد	عملکرد	Ncs
عملی	عملی	As
عملیات	عملیات	Ncs
عمو	عمو	Ncs
عموم	عموم	Ncs
عموم	عموم	Tf
عمومی	عمومی	As
عمیق	عمیق	As
عمیقتر	عمیق	Ac
عمیقی	عمیق	As
عناصر	عنصر	Ncl
عنایت	عنایت	Ncs
عنبر	عنبر	Ncs
عنوان	عنوان	Ncs
عوارض	عارضه	Ncl
عواطف	عاطفه	Ncl
عواقب	عاقبت	Ncl
عوامل	عامل	Ncl
عواملی	عامل	Ncl
عوض	عوض	Ncs
عهده	عهده	Ncs
عیار	عیار	Rj
عین	عین	Ncs
عینی	عینی	As
غارت	غارت	Ncs
غارتگری	غارتگری	Ncs
غاصب	غاصب	As
غافلگیر	غافلگیر	As
غالبا	غالبا	Dg
غذا	غذا	Ncs
غذاخوری	غذاخوری	As
غذاها	غذا	Ncl
غذاهای	غذا	Ncl
غذاهایی	غذا	Ncl
غذای	غذا	Ncs
غذایی	غذا	Ncs
غذایی	غذایی	As
غربی	غربی	As
غرق	غرق	As
غریب	غریب	As
غریو	غریو	Ncs
غزالان	غزال	Nal
غضروف	غضروف	Ncs
غضروفهای	غضروف	Ncl
غفران	غفران	Ncs
غلات	غله	Ncl
غلامحسین	غلامحسین	Nas
غلامرضا	غلامرضا	Nas
غلبه	غلبه	Ncs
غلط	غلط	As
غیاب	غیاب	Ncs
غیراخلاقی	غیراخلاقی	As
غیرانقلابی	غیرانقلابی	As
غیرتخصصی	غیرتخصصی	As
غیردولتی	غیردولتی	As
غیرعادی	غیرعادی	As
غیرقانونی	غیرقانونی	As
غیرقانونی	غیرقانونی	Dg
غیرمحقق	غیرمحقق	As
غیرمذهبی	غیرمذهبی	As
غیرمستقیم	غیرمستقیم	As
غیرمسیحی	غیرمسیحی	As
غیرمعنوی	غیرمعنوی	As
غیرمنتظره	غیرمنتظره	As
غیرمنطقی	غیرمنطقی	As
غیرموثق	غیرموثق	As
غیرنفتی	غیرنفتی	As
فاتح	فاتح	As
فاتح	فاتح	Ncs
فارس	فارس	Nas
فارنهایت	فارنهایت	Ncs
فاز	فاز	Ncs
فاصله	فاصله	Ncs
فاضل	فاضل	As
فاضلاب	فاضلاب	Ncs
فاضلابها	فاضلاب	Ncl
فاطیمای	فاطیمای	Nas
فامیل	فامیل	Ncs
فانتزی	فانتزی	As
فایبرگلاس	فایبرگلاس	Ncs
فحش	فحش	Ncs
فداکار	فداکار	As
فداکاری	فداکاری	Ncs
فدرال	فدرال	As
فرا	فرا	E-
فراتر	فرا	Ac
فرار	فرار	Ncs
فراز	فراز	Ncs
فراگیری	فراگیری	Ncs
فراموش	فراموش	As
فرانسوا	فرانسوا	Nas
فرانسوی	فرانسوی	Nas
فرانسه	فرانسه	Nas
فرانک	فرانک	Nas
فرانکفورت	فرانکفورت	Nas
فراوان	فراوان	As
فراوانی	فراوان	As
فراوانی	فراوانی	Ncs
فراهم	فراهم	Ncs
فرایند	فرایند	Ncs
فرآیند	فرآیند	Ncs
فرجی	فرجی	Nas
فرد	فرد	Ncs
فردا	فردا	Dg
فردوسی	فردوسی	Nas
فردی	فرد	Ncs
فردی	فردی	As
فرزانه	فرزانه	As
فرزدق	فرزدق	Nas
فرزند	فرزند	Ncs
فرزندان	فرزند	Ncl
فرستادند	فرستادن,فرست,فرستاد	Vpy
فرصت	فرصت	Ncs
فرصتها	فرصت	Ncl
فرصتهای	فرصت	Ncl
فرصتی	فرصت	Ncs
فرض	فرض	Ncs
فرق	فرق	Ncs
فرقه	فرقه	Ncs
فرم	فرم	Ncs
فرمان	فرمان	Ncs
فرمانروای	فرمانروا	Ncs
فرماید	فرمودن,فرما,فرمود	Vpy
فرمها	فرم	Ncl
فرناندز	فرناندز	Nas
فرنگی	فرنگی	As
فرو	فرو	E-
فرود	فرود	Ncs
فرودگاه	فرودگاه	Ncs
فروردین	فروردین	Nas
فروش	فروش	Ncs
فروغ	فروغ	Ncs
فروغی	فروغی	Nas
فرهنگ	فرهنگ	Ncs
فرهنگها	فرهنگ	Ncl
فرهنگهای	فرهنگ	Ncl
فرهنگی	فرهنگی	As
فریاد	فریاد	Ncs
فریب	فریب	Ncs
فریبرز	فریبرز	Nas
فریبنده	فریبنده	As
فریفت	فریفتن,فریب,فریفت	Vpy
فساد	فساد	Ncs
فشار	فشار	Ncs
فشارها	فشار	Ncl
فشارهای	فشار	Ncl
فصل	فصل	Ncs
فصلی	فصلی	As
فضا	فضا	Ncs
فضاپیمایی	فضاپیما	Ncs
فضاسازیهای	فضاسازی	Ncl
فضانورد	فضانورد	Ncs
فضانوردان	فضانورد	Ncl
فضای	فضا	Ncs
فضایل	فضیلت	Ncl
فضایی	فضا	Ncs
فضایی	فضایی	As
فضل	فضل	Ncs
فضلا	فاضل	Ncl
فضولات	فضل	Ncl
فعال	فعال	As
فعالان	فعال	Ncl
فعالیت	فعالیت	Ncs
فعالیتهای	فعالیت	Ncl
فعلی	فعلی	As
فقرای	فقر	Ncl
فقط	فقط	Dg
فقه	فقه	Ncs
فقیرتر	فقیر	Ac
فکر	فکر	Ncs
فکری	فکری	As
فلاتهای	فلات	Ncl
فلجی	فلجی	Ncs
فلسطینیان	فلسطین	Ncl
فلسفی	فلسفی	As
فلک	فلک	Ncs
فنی	فنی	As
فوتبال	فوتبال	Ncs
فوتسال	فوتسال	Ncs
فور	فور	Nas
فوری	فوری	As
فوریت	فوریت	Ncs
فوریه	فوریه	Nas
فوق	فوق	As
فوکو	فوکو	Nas
فیبر	فیبر	Nas
فیروزه	فیروزه	Ncs
فیزیکی	فیزیکی	As
فیزیولوژیکی	فیزیولوژیکی	As
فیلد	فیلد	Nas
فیلم	فیلم	Ncs
فیلمهای	فیلم	Ncl
فیلمهایی	فیلم	Ncl
فیلمی	فیلم	Ncs
فیلیپین	فیلیپین	Nas
قابل	قابل	As
قابلیتها	قابلیت	Ncl
قادر	قادر	As
قاضی	قاضی	Nas
قاطبه	قاطبه	Tf
قاطر	قاطر	Ncs
قاطع	قاطع	As
قالب	قالب	Ncs
قانع	قانع	As
قانون	قانون	Ncs
قانونی	قانون	Ncs
قانونی	قانونی	As
قبال	قبال	Ncs
قبایل	قبیله	Ncl
قبر	قبر	Ncs
قبل	قبل	Dg
قبل	قبل	E-
قبلا	قبلا	Dg
قبول	قبول	As
قبیل	قبیل	Ncs
قبیله	قبیله	Ncs
قتل	قتل	Ncs
قتلهای	قتل	Ncl
قحطی	قحطی	Ncs
قدر	قدر	Ncs
قدرت	قدرت	Ncs
قدرتمند	قدرتمند	As
قدری	قدری	Di
قدس	قدس	Nas
قدم	قدم	Ncs
قدیمی	قدیمی	As
قرار	قرار	Ncs
قراردادی	قرارداد	Ncs
قرآن	قرآن	Nas
قربانی	قربانی	Ncs
قربانیان	قربانی	Ncl
قرص	قرص	Ncs
قرصها	قرص	Ncl
قرصهای	قرص	Ncl
قرق	قرق	Ncs
قرقیزستان	قرقیزستان	Nas
قرن	قرن	Ncs
قرون	قرن	Ncl
قریب	قریب	As
قریب	قریب	Tf
قزاقستان	قزاقستان	Nas
قساوت	قساوت	Ncs
قسمت	قسمت	Ncs
قصاص	قصاص	Ncs
قصد	قصد	Ncs
قصر	قصر	Ncs
قضات	قاضی	Ncl
قضاوت	قضاوت	Ncs
قضایا	قضیه	Ncl
قضایی	قضایی	As
قضائیه	قضائیه	As
قطار	قطار	Ncs
قطارهای	قطار	Ncl
قطب	قطب	Nas
قطر	قطر	Nas
قطر	قطر	Ncs
قطع	قطع	Ncs
قطعی	قطعی	As
قلابی	قلابی	As
قلب	قلب	Ncs
قلبی	قلبی	As
قلم	قلم	Ncs
قلمرو	قلمرو	Ncs
قنبری	قنبری	Nas
قند	قند	Ncs
قواعد	قاعده	Ncl
قوانین	قانون	Ncl
قوای	قوه	Ncl
قوت	قوت	Ncs
قوسها	قوس	Ncl
قول	قول	Ncs
قوم	قوم	Ncs
قومی	قومی	As
قوه	قوه	Ncs
قوی	قوی	As
قهرمانان	قهرمان	Ncl
قهرمانی	قهرمانی	Ncs
قهریه	قهریه	As
قید	قید	Ncs
قیدوبند	قیدوبند	Ncs
قیمت	قیمت	Ncs
قیمتهای	قیمت	Ncl
قیمتی	قیمت	Ncs
کابوسهای	کابوس	Ncl
کابوسهایی	کابوس	Ncl
کابینه	کابینه	Ncs
کاج	کاج	Ncs
کاخ	کاخ	Ncs
کار	کار	Ncs
کارابولو	کارابولو	Nas
کاربرد	کاربرد	Ncs
کاربری	کاربری	Ncs
کارتاخنا	کارتاخنا	Nas
کارخانه	کارخانه	Ncs
کارشناس	کارشناس	Ncs
کارشناسان	کارشناس	Ncl
کارشناسانه	کارشناسانه	As
کارشناسی	کارشناسی	Ncs
کارکرد	کارکرد	Ncs
کارکردهای	کارکرد	Ncl
کارکنان	کارکن	Ncl
کارگاه	کارگاه	Ncs
کارگر	کارگر	Ncs
کارگران	کارگر	Ncl
کارگردان	کارگردان	Ncs
کارگردانی	کارگردانی	Ncs
کارگزاران	کارگزار	Ncl
کارگه	کارگه	Ncs
کارمند	کارمند	Ncs
کارمندان	کارمند	Ncl
کاروان	کاروان	Ncs
کاروانی	کاروان	Ncs
کاروبار	کاروبار	Ncs
کارولینای	کارولینای	Nas
کارهای	کار	Ncl
کاری	کار	Ncs
کاریکاتور	کاریکاتور	Ncs
کاریکاتوریست	کاریکاتوریست	Ncs
کاستن	کاستن,کاه,کاست	Vp-
کاسته	کاستن,کاه,کاست	Vp-
کاشان	کاشان	Nas
کاغذگرانی	کاغذگرانی	Ncs
کاغذگرونی	کاغذگرونی	Ncs
کافی	کافی	As
کالا	کالا	Ncs
کالاهای	کالا	Ncl
کالای	کالا	Ncs
کالبد	کالبد	Ncs
کام	کام	Ncs
کامل	کامل	As
کاملا	کاملا	Di
کاملی	کامل	As
کان	کان	Rw
کانادا	کانادا	Nas
کانادایی	کانادایی	As
کانالها	کانال	Ncl
کانتیکت	کانتیکت	Nas
کانتینری	کانتینری	As
کانگورو	کانگورو	Ncs
کانون	کانون	Ncs
کاوش	کاوش	Ncs
کاوشگر	کاوشگر	Ncs
کاوشگری	کاوشگر	Ncs
کاهش	کاهش	Ncs
کائنات	کائن	Ncl
کتاب	کتاب	Ncs
کتابها	کتاب	Ncl
کتابی	کتاب	Ncs
کتب	کتاب	Ncl
کتیبه	کتیبه	Ncs
کثیرالانتشار	کثیرالانتشار	As
کثیف	کثیف	As
کجا	کجا	Dg
کدام	کدام	Ncs
کدام	کدام	Tq
کذب	کذب	As
کربلای	کربلای	Nas
کربوهیدرات	کربوهیدرات	Nas
کربوهیدراتها	کربوهیدرات	Nal
کرج	کرج	Nas
کرد	کرد	As
کرد	کردن,کن,کرد	Vpy
کردم	کردن,کن,کرد	Vpy
کردن	کردن,کن,کرد	Vp-
کردند	کردن,کن,کرد	Vpy
کرده	کردن,کن,کرد	Vp-
کردیم	کردن,کن,کرد	Vpy
کرم	کرم	Ncs
کرمان	کرمان	Nas
کرمانشاه	کرمانشاه	Nas
کرمانی	کرمانی	Nas
کرون	کرون	Nas
کره	کره	Nas
کریستی	کریستی	Nas
کریم	کریم	Nas
کساد	کساد	As
کسانی	کس	Ncl
کسب	کسب	Ncs
کسی	کس	Ncs
کشاندن	کشاندن,کشان,کشاند	Vp-
کشاورزان	کشاورز	Ncl
کشاورزی	کشاورزی	Ncs
کشت	کشت	Ncs
کشتزاری	کشتزار	Ncs
کشته	کشتن,کش,کشت	Vp-
کشتی	کشتی	Ncs
کشتیم	کشتن,کش,کشت	Vpy
کشف	کشف	Ncs
کشور	کشور	Ncs
کشورهای	کشور	Ncl
کشید	کشیدن,کش,کشید	Vpy
کشیده	کشیدن,کش,کشید	Vp-
کشیش	کشیش	Ncs
کعب	کعب	Nas
کفن	کفن	Ncs
کلاژن	کلاژن	Nas
کلان	کلان	As
کلان	کلان	Ncs
کلاه	کلاه	Ncs
کلسترول	کلسترول	Nas
کلسترول	کلسترول	Ncs
کلسیم	کلسیم	Ncs
کلک	کلک	Ncs
کلمات	کلمه	Ncl
کلی	کلی	As
کلیت	کلیت	Ncs
کلیدی	کلیدی	As
کلیر	کلیر	Nas
کلیسا	کلیسا	Ncs
کلیسای	کلیسا	Ncs
کلینگر	کلینگر	Nas
کلیوی	کلیوی	As
کلیه	کلیه	Ncs
کلیه	کلیه	Tf
کمبود	کمبود	Ncs
کمتر	کم	Ac
کمتر	کمتر	Dg
کمتر	کمتر	Di
کمتری	کم	Ac
کمتری	کمتر	As
کمترین	کم	Au
کمدی	کمدی	As
کمر	کمر	Ncs
کمک	کمک	Ncs
کمکها	کمک	Ncl
کمکهای	کمک	Ncl
کمی	کم	As
کمی	کمی	As
کمی	کمی	Dg
کمیته	کمیته	Ncs
کمیسیون	کمیسیون	Ncs
کنار	کنار	Dg
کنار	کنار	Ez
کناره	کناره	Ncs
کنت	کنت	Nas
کنترل	کنترل	Ncs
کنجکاو	کنجکاو	As
کند	کردن,کن,کرد	Vpy
کند	کند	As
کندتر	کند	Ac
کنـدو	کنـدو	Nas
کندو	کندو	Nas
کنش	کنش	Ncs
کنفرانس	کنفرانس	Ncs
کنگره	کنگره	Ncs
کنند	کردن,کن,کرد	Vpy
کنون	کنون	Dg
کنونی	کنونی	As
کنید	کردن,کن,کرد	Vpy
کنیم	کردن,کن,کرد	Vpy
کوبا	کوبا	Nas
کوپه	کوپه	Nas
کوتاه	کوتاه	As
کوتاهی	کوتاه	As
کوتاهی	کوتاهی	Ncs
کوچک	کوچک	As
کوچکتر	کوچک	Ac
کوچکی	کوچک	As
کوچه	کوچه	Ncs
کود	کود	Ncs
کودتای	کودتا	Ncs
کودک	کودک	Ncs
کودکان	کودک	Ncl
کوران	کوران	Ncs
کورو	کورو	Nas
کوسه	کوسه	Ncs
کوششی	کوشش	Ncs
کوفه	کوفه	Nas
کوکائین	کوکائین	Nas
کونتین	کونتین	Nas
کوهسار	کوهسار	Ncs
کویری	کویری	As
کوین	کوین	Nas
کهنسال	کهنسال	As
کهنه	کهنه	As
کیزوابوچی	کیزوابوچی	Nas
کیسه	کیسه	Ncs
کیش	کیش	Nas
کیفی	کیفی	As
کیک	کیک	Ncs
کیلوگرم	کیلوگرم	Ncs
کیلومتر	کیلومتر	Ncs
کیلومتری	کیلومتری	Rj
کینه	کینه	Ncs
کیهان	کیهان	Nas
گاتنر	گاتنر	Nas
گاز	گاز	Ncs
گازرسانی	گازرسانی	Ncs
گالری	گالری	Ncs
گالوپ	گالوپ	Nas
گام	گام	Ncs
گاما	گاما	Nas
گاندی	گاندی	Nas
گاه	گاه	Dg
گاه	گاه	Ncs
گذاشت	گذاشتن,گذار,گذاشت	Vpy
گذاشتن	گذاشتن,گذار,گذاشت	Vp-
گذاشته	گذاشتن,گذار,گذاشت	Vp-
گذر	گذر	Ncs
گذران	گذران	Ncs
گذرانیده	گذرانیدن,گذران,گذرانید	Vp-
گذشت	گذشت	Ncs
گذشت	گذشتن,گذر,گذشت	Vpy
گذشته	گذشته	Dg
گذشته	گذشته	Ncs
گرامی	گرامی	As
گرامیتر	گرامی	Ac
گران	گران	As
گرانبهای	گرانبهای	As
گرانقدر	گرانقدر	As
گراوور	گراوور	Ncs
گرایش	گرایش	Ncs
گرایشها	گرایش	Ncl
گرایشهای	گرایش	Ncl
گرچه	گرچه	J-
گردانندگان	گرداننده	Ncl
گردانید	گردانیدن,گردان,گردانید	Vpy
گردد	گشتن,گرد,گشت	Vpy
گردن	گردن	Ncs
گردون	گردون	Ncs
گردهمایی	گردهمایی	Ncs
گردید	گردیدن,گرد,گردید	Vpy
گردیده	گردیدن,گرد,گردید	Vp-
گرزنون	گرزنون	Ncs
گرسنگی	گرسنگی	Ncs
گرفت	گرفتن,گیر,گرفت	Vpy
گرفتار	گرفتار	As
گرفتن	گرفتن,گیر,گرفت	Vp-
گرفتند	گرفتن,گیر,گرفت	Vpy
گرفته	گرفتن,گیر,گرفت	Vp-
گرفته	گرفته	J-
گرم	گرم	As
گرم	گرم	Ls
گرما	گرما	Ncs
گرمای	گرما	Ncs
گرمخانه	گرمخانه	Ncs
گرنبر	گرنبر	Nas
گرو	گرو	Ncs
گروه	گروه	Ncs
گروهها	گروه	Ncl
گروههای	گروه	Ncl
گروهی	گروه	Ncs
گروهی	گروهی	As
گره	گره	Ncs
گری	گری	Nas
گریختند	گریختن,گریز,گریخت	Vpy
گریزان	گریزان	As
گرینر	گرینر	Nas
گزارش	گزارش	Ncs
گزارشی	گزارش	Ncs
گزیده	گزیدن,گزین,گزید	Vp-
گسترد	گستردن,گستر,گسترد	Vpy
گستردگی	گستردگی	Ncs
گسترده	گسترده	As
گسترش	گسترش	Ncs
گشایش	گشایش	Ncs
گشت	گشتن,گرد,گشت	Vpy
گشودند	گشودن,گشا,گشود	Vpy
گفت	گفت	Ncs
گفت	گفتن,گو,گفت	Vpy
گفتار	گفتار	Ncs
گفتگو	گفتگو	Ncs
گفتگوهای	گفتگو	Ncl
گفتگوی	گفتگو	Ncs
گفتن	گفتن,گو,گفت	Vp-
گفته	گفتن,گو,گفت	Vp-
گفته	گفته	Ncs
گلایه	گلایه	Ncs
گلپایگانی	گلپایگانی	Nas
گلزنی	گلزنی	Ncs
گلستان	گلستان	Nas
گلهای	گل	Ncl
گماشت	گماشتن,گمار,گماشت	Vpy
گمان	گمان	Ncs
گمرک	گمرک	Ncs
گمنام	گمنام	As
گنجاند	گنجاندن,گنجان,گنجاند	Vpy
گنجاندن	گنجاندن,گنجان,گنجاند	Vp-
گندم	گندم	Ncs
گندمهای	گندم	Ncl
گواتر	گواتر	Ncs
گوارش	گوارش	Ncs
گوجه	گوجه	Ncs
گور	گور	Ncs
گوردون	گوردون	Nas
گورستان	گورستان	Ncs
گورهای	گور	Ncl
گوسفندانی	گوسفند	Ncl
گوش	گوش	Ncs
گوناگون	گوناگون	As
گوناگونی	گوناگون	As
گونه	گونه	Ls
گونه	گونه	Ncs
گوهر	گوهر	Ncs
گوهرهای	گوهر	Ncl
گویای	گویا	As
گویش	گویش	Ncs
گویی	گویی	Dg
گیاهی	گیاهی	As
گیرد	گرفتن,گیر,گرفت	Vpy
گیرند	گرفتن,گیر,گرفت	Vpy
گیسوان	گیسو	Ncl
گینه	گینه	Nas
لازم	لازم	As
لاکتوز	لاکتوز	Ncs
لایحه	لایحه	Ncs
لاینقطع	لاینقطع	As
لائیک	لائیک	As
لباس	لباس	Ncs
لبخند	لبخند	Ncs
لبنان	لبنان	Nas
لثه	لثه	Ncs
لجنهای	لجن	Ncl
لحاظ	لحاظ	Ncs
لحظات	لحظه	Ncl
لحن	لحن	Ncs
لحود	لحود	Nas
لذا	لذا	J-
لذایذ	لذت	Ncl
لذت	لذت	Ncs
لرد	لرد	Nas
لرزاند	لرزاندن,لرزان,لرزاند	Vpy
لرزش	لرزش	Ncs
لرزید	لرزیدن,لرز,لرزید	Vpy
لرزیدن	لرزیدن,لرز,لرزید	Vp-
لرستان	لرستان	Nas
لشکرکشی	لشکرکشی	Ncs
لطافت	لطافت	Ncs
لطفی	لطفی	Nas
لغو	لغو	Ncs
لفظی	لفظی	As
لکنت	لکنت	Ncs
لکه	لکه	Ncs
لگد	لگد	Ncs
لندن	لندن	Nas
لوازم	لازم	Ncl
لواسان	لواسان	Nas
لواسانات	لواسانات	Nas
لوبیا	لوبیا	Ncs
لوسمی	لوسمی	Ncs
لوسیون	لوسیون	Nas
لوله	لوله	Ncs
لیبرال	لیبرال	As
لیبی	لیبی	Nas
لیونل	لیونل	Nas
مابقی	مابقی	Ncs
ماجرا	ماجرا	Ncs
ماجرای	ماجرا	Ncs
ماجرایی	ماجرا	Ncs
مادر	مادر	Ncs
مادرانی	مادر	Ncl
مادرید	مادرید	Nas
ماده	ماده	Ncs
مارک	مارک	Nas
مارک	مارک	Ncs
مارکس	مارکس	Nas
مارکسیست	مارکسیست	As
ماری	ماری	Nas
ماساچوست	ماساچوست	Nas
مافیا	مافیا	Nas
مافیایی	مافیایی	As
ماکائو	ماکائو	Nas
مال	مال	Ncs
مالزی	مالزی	Nas
مالک	مالک	Nas
مالک	مالک	Ncs
مالی	مالی	As
مالیک	مالیک	Ncs
مأمور	مأمور	Ncs
مأموران	مأمور	Ncl
مأموریت	مأموریت	Ncs
مان	مان	Ce
مانا	مانا	Nas
ماند	ماندن,مان,ماند	Vpy
ماندگارتر	ماندگار	Ac
ماندن	ماندن,مان,ماند	Vp-
ماندند	ماندن,مان,ماند	Vpy
مانده	مانده	As
مانع	مانع	Ncs
مانند	مانند	Dg
ماه	ماه	Ncs
ماهانه	ماهانه	As
ماهیت	ماهیت	Ncs
مایع	مایع	Ncs
مایل	مایل	As
ماینوکسیدیل	ماینوکسیدیل	Nas
مایه	مایه	Ncs
مباحث	مبحث	Ncl
مباحثات	مباحثه	Ncl
مبادلات	مبادله	Ncl
مبارزات	مبارزه	Ncl
مبارزه	مبارزه	Ncs
مبارک	مبارک	As
مبالغ	مبلغ	Ncl
مبانی	مبنی	Ncl
مبتکر	مبتکر	Ncs
مبتلا	مبتلا	As
مبتلایان	مبتلا	Ncl
مبدا	مبدا	Ncs
مبدأ	مبدأ	Ncs
مبدل	مبدل	As
مبذول	مبذول	As
مبرا	مبرا	As
مبلغ	مبلغ	Ncs
مبلغی	مبلغ	Ncs
مبنی	مبنی	As
متابولیسم	متابولیسم	Ncs
متاسفانه	متاسفانه	Dg
متأسفانه	متأسفانه	Dg
متانت	متانت	Ncs
متحدی	متحدی	Nas
متحول	متحول	As
متخصص	متخصص	As
متخصص	متخصص	Ncs
متخصصان	متخصص	Ncl
متذکر	متذکر	As
متر	متر	Ls
متر	متر	Ncs
متری	متری	Ncs
متشکل	متشکل	As
متصل	متصل	As
متعدد	متعدد	As
متعددی	متعدد	As
متعلق	متعلق	As
متفاوت	متفاوت	As
متفاوتی	متفاوت	As
متفکر	متفکر	As
متقابل	متقابل	As
متکی	متکی	As
متلاشی	متلاشی	As
متمرکز	متمرکز	As
متمم	متمم	As
متن	متن	Ncs
متنوع	متنوع	As
متنوعی	متنوع	As
متوالی	متوالی	As
متوجه	متوجه	As
متوجه	متوجه	Ncs
متوسط	متوسط	As
متوسط	متوسط	Ncs
متوسطه	متوسطه	As
متوسل	متوسل	As
متوقف	متوقف	As
متهم	متهم	As
متهم	متهم	Ncs
متهمین	متهم	Ncl
متین	متین	As
مثابه	مثابه	Ncs
مثال	مثال	Ncs
مثالی	مثال	Ncs
مثبت	مثبت	As
مثبته	مثبته	As
مثبتی	مثبت	As
مثل	مثل	Dg
مثلا	مثلا	Dg
مجاز	مجاز	As
مجال	مجال	Ncs
مجانی	مجانی	As
مجاهدین	مجاهد	Ncl
مجبور	مجبور	As
مجتبی	مجتبی	Nas
مجتمع	مجتمع	Ncs
مجدد	مجدد	As
مجرا	مجرا	Ncs
مجرای	مجرا	Ncs
مجریان	مجری	Ncl
مجسم	مجسم	As
مجسمه	مجسمه	Ncs
مجعول	مجعول	As
مجلات	مجله	Ncl
مجلس	مجلس	Ncs
مجلسین	مجلس	Ncl
مجله	مجله	Ncs
مجمع	مجمع	Ncs
مجموع	مجموع	Ncs
مجموعه	مجموعه	Ncs
مجید	مجید	Nas
مجیدی	مجیدی	Nas
محافل	محفل	Ncl
محافلی	محفل	Ncl
محاق	محاق	Ncs
محاکم	محکمه	Ncl
محاکمه	محاکمه	Ncs
محبوبیت	محبوبیت	Ncs
محتاج	محتاج	As
محترم	محترم	As
محتوا	محتوا	Ncs
محتوای	محتوا	Ncs
محدود	محدود	As
محدودی	محدود	As
محدودیت	محدودیت	Ncs
محدودیتی	محدودیت	Ncs
محرمیت	محرمیت	Ncs
محروم	محروم	As
محسن	محسن	Nas
محسوب	محسوب	As
محصولات	محصوله	Ncl
محض	محض	Ncs
محضر	محضر	Ncs
محفل	محفل	Ncs
محفوظ	محفوظ	As
محقق	محقق	Nas
محقق	محقق	Ncs
محققان	محقق	Ncl
محققین	محقق	Ncl
محکم	محکم	As
محکوم	محکوم	As
محکومیتی	محکومیت	Ncs
محل	محل	Ncs
محله	محله	Ncs
محلی	محل	Ncs
محلی	محلی	As
محمد	محمد	Nas
محمدرضا	محمدرضا	Nas
محمدعلی	محمدعلی	Nas
محملی	محمل	Ncs
محمود	محمود	Nas
محور	محور	Ncs
محوری	محوری	As
محیط	محیط	Ncs
محیطی	محیط	Ncs
مخاطب	مخاطب	Ncs
مخاطبان	مخاطب	Ncl
مخالف	مخالف	As
مخالفان	مخالف	Ncl
مخالفت	مخالفت	Ncs
مخالفتها	مخالفت	Ncl
مخالفتهایی	مخالفت	Ncl
مختل	مختل	As
مختلف	مختلف	As
مخدر	مخدر	As
مخدوش	مخدوش	As
مخرب	مخرب	As
مخصوص	مخصوص	As
مخملباف	مخملباف	Nas
مداخله	مداخله	Ncs
مدار	مدار	Ncs
مدارا	مدارا	Ncs
مدارک	مدرک	Ncl
مدال	مدال	Ncs
مداوم	مداوم	As
مدبرانه	مدبرانه	As
مدت	مدت	Ncs
مدتها	مدت	Ncl
مدتی	مدت	Ncs
مدرسه	مدرسه	Ncs
مدرسین	مدرس	Ncl
مدرکی	مدرک	Ncs
مدعاهای	مدعا	Ncl
مدعی	مدعی	As
مدعی	مدعی	Ncs
مدعیان	مدعی	Ncl
مدنی	مدنی	As
مدیر	مدیر	Ncs
مدیران	مدیر	Ncl
مدیریت	مدیریت	Ncs
مدیریتی	مدیریتی	As
مدینه	مدینه	Nas
مذاکره	مذاکره	Ncs
مذکور	مذکور	As
مذهب	مذهب	Ncs
مذهبی	مذهبی	As
مراتب	مرتبه	Ncl
مراتع	مرتع	Ncl
مراجع	مرجع	Ncl
مراجعات	مراجعه	Ncl
مراجعت	مراجعت	Ncs
مراجعه	مراجعه	Ncs
مراحل	مرحله	Ncl
مراسم	مراسم	Ncs
مراسمی	مراسم	Ncs
مراقبت	مراقبت	Ncs
مربوط	مربوط	As
مربوطه	مربوطه	As
مرتب	مرتب	Dg
مرتضی	مرتضی	Nas
مرتع	مرتع	Ncs
مرتعداری	مرتعداری	Ncs
مرتفع	مرتفع	As
مرتکب	مرتکب	As
مرحله	مرحله	Ncs
مرحوم	مرحوم	Nas
مرخصی	مرخصی	Ncs
مرد	مرد	Ncs
مرداد	مرداد	Nas
مرداس	مرداس	Nas
مردان	مرد	Ncl
مردانه	مردانه	As
مردگان	مرده	Ncl
مردم	مردم	Ncl
مردمان	مردم	Ncl
مردمی	مردم	Ncl
مردمی	مردمی	As
مرزها	مرز	Ncl
مرزهای	مرز	Ncl
مرغوبیت	مرغوبیت	Ncs
مرکز	مرکز	Ncs
مرکزی	مرکزی	As
مرکوری	مرکوری	Nas
مرگ	مرگ	Ncs
مرگبار	مرگبار	As
مرمت	مرمت	Ncs
مرمر	مرمر	Ncs
مرمری	مرمری	As
مرمرین	مرمرین	As
مرموز	مرموز	As
مروان	مروان	Nas
مروری	مرور	Ncs
مری	مری	Ncs
مریخ	مریخ	Nas
مریضی	مریض	Ncs
مزایده	مزایده	Ncs
مزبور	مزبور	As
مزدوری	مزدور	Ncs
مزمن	مزمن	As
مزین	مزین	As
مسابقات	مسابقه	Ncl
مسابقه	مسابقه	Ncs
مساجد	مسجد	Ncl
مسافرت	مسافرت	Ncs
مسافرتهای	مسافرت	Ncl
مسافری	مسافری	As
مساله	مساله	Ncs
مساوی	مساوی	As
مسایل	مسئله	Ncl
مسائل	مسئله	Ncl
مسائلی	مسئله	Ncl
مستثنی	مستثنی	As
مستحضر	مستحضر	As
مستقل	مستقل	As
مستقلی	مستقل	As
مستقیم	مستقیم	As
مستلزم	مستلزم	Ncs
مستمر	مستمر	As
مستند	مستند	As
مستند	مستند	Dg
مستوجب	مستوجب	Ncs
مستی	مستی	Ncs
مسجد	مسجد	Ncs
مسعود	مسعود	Nas
مسلح	مسلح	As
مسلط	مسلط	As
مسلم	مسلم	As
مسلمان	مسلمان	As
مسلمان	مسلمان	Ncs
مسلمانان	مسلمان	Ncl
مسموم	مسموم	As
مسن	مسن	As
مسیحی	مسیحی	As
مسیر	مسیر	Ncs
مسئلت	مسئلت	Ncs
مسئله	مسئله	Ncs
مسئول	مسئول	As
مسئول	مسئول	Ncs
مسئولان	مسئول	Ncl
مسئولیت	مسئولیت	Ncs
مشابه	مشابه	As
مشابهی	مشابه	As
مشاجره	مشاجره	Ncs
مشارکت	مشارکت	Ncs
مشاور	مشاور	Ncs
مشاوره	مشاوره	Ncs
مشاهده	مشاهده	Ncs
مشاهیر	مشهور	Ncl
مشایعت	مشایعت	Ncs
مشبک	مشبک	As
مشترک	مشترک	As
مشتمل	مشتمل	As
مشتها	مشت	Ncl
مشخص	مشخص	As
مشخصی	مشخص	As
مشروع	مشروع	As
مشروعیت	مشروعیت	Ncs
مشعل	مشعل	Ncs
مشغول	مشغول	As
مشکل	مشکل	Ncs
مشکلات	مشکل	Ncl
مشکلاتی	مشکل	Ncl
مشکلی	مشکل	Ncs
مشکوک	مشکوک	As
مشورت	مشورت	Ncs
مشورتی	مشورتی	As
مشهد	مشهد	Nas
مشهور	مشهور	As
مشهورترین	مشهور	Au
مشی	مشی	Ncs
مصاحبه	مصاحبه	Ncs
مصادره	مصادره	Ncs
مصادیق	مصداق	Ncl
مصالح	مصلحت	Ncl
مصدر	مصدر	Ncs
مصدق	مصدق	Nas
مصرف	مصرف	Ncs
مصری	مصری	As
مصلحت	مصلحت	Ncs
مصمم	مصمم	As
مصنوعی	مصنوعی	As
مصوب	مصوب	As
مصوبه	مصوبه	Ncs
مصون	مصون	As
مصونیت	مصونیت	Ncs
مضیقه	مضیقه	Ncs
مطابق	مطابق	As
مطالب	مطلب	Ncl
مطالبات	مطالبه	Ncl
مطالبه	مطالبه	Ncs
مطالعات	مطالعه	Ncl
مطالعه	مطالعه	Ncs
مطبوعات	مطبوع	Ncl
مطبوعاتی	مطبوعاتی	As
مطبوعه	مطبوعه	Ncs
مطرح	مطرح	As
مطلب	مطلب	Ncs
مطلع	مطلع	Ncs
مطلوب	مطلوب	As
مطمئن	مطمئن	As
مظفریان	مظفریان	Nas
مظلوم	مظلوم	As
مظهری	مظهر	Ncs
معابدی	معبد	Ncl
معابر	معبر	Ncl
معادل	معادل	As
معارض	معارض	As
معاش	معاش	Ncs
معاصر	معاصر	As
معالج	معالج	Ncs
معالجه	معالجه	Ncs
معاند	معاند	As
معاون	معاون	Ncs
معاونان	معاون	Ncl
معاونت	معاونت	Ncs
معاویه	معاویه	Nas
معاینات	معاینه	Ncl
معاینه	معاینه	Ncs
معبد	معبد	Ncs
معبدی	معبد	Ncs
معتبرترین	معتبر	Au
معتدل	معتدل	As
معتقد	معتقد	As
معدنی	معدنی	As
معدود	معدود	As
معدود	معدود	Ls
معده	معده	Ncs
معرض	معرض	Ncs
معرف	معرف	Ncs
معرفی	معرفی	Ncs
معرق	معرق	As
معروف	معروف	As
معروفترین	معروف	Au
معطوف	معطوف	As
معظم	معظم	As
معقولی	معقول	As
معکوس	معکوس	As
معلا	معلا	As
معلم	معلم	Ncs
معلولیت	معلولیت	Ncs
معلوم	معلوم	As
معماری	معماری	Ncs
معمای	معما	Ncs
معمول	معمول	As
معمولا	معمولا	Dg
معنای	معنا	Ncs
معنوی	معنوی	As
معنی	معنی	Ncs
معیشتی	معیشت	As
مغذی	مغذی	As
مغز	مغز	Ncs
مغزی	مغزی	As
مغولان	مغول	Nal
مفاد	مفاد	Ncs
مفاصل	مفصل	Ncl
مفرح	مفرح	Nas
مفهوم	مفهوم	Ncs
مفید	مفید	As
مقابر	مقبره	Ncl
مقابل	مقابل	As
مقابل	مقابل	Ez
مقابل	مقابل	Ncs
مقابله	مقابله	Ncs
مقادیر	مقدار	Ncl
مقاطع	مقطع	Ncl
مقاله	مقاله	Ncs
مقام	مقام	Ncs
مقامات	مقام	Ncl
مقامهای	مقام	Ncl
مقامی	مقام	Ncs
مقاوم	مقاوم	As
مقاومت	مقاومت	Ncs
مقایسه	مقایسه	Ncs
مقبولیت	مقبولیت	Ncs
مقتضی	مقتضی	As
مقتضیات	مقتضیه	Ncl
مقدار	مقدار	Ncs
مقداری	مقدار	Ncs
مقدس	مقدس	As
مقدم	مقدم	As
مقدماتی	مقدم	Ncl
مقدماتی	مقدماتی	As
مقدمه	مقدمه	Ncs
مقدمی	مقدمی	Nas
مقرر	مقرر	As
مقررات	مقرره	Ncl
مقصد	مقصد	Ncs
مقصر	مقصر	Ncs
مقوله	مقوله	Ncs
مقید	مقید	As
مکاتبات	مکاتبه	Ncl
مکاتبه	مکاتبه	Ncs
مکان	مکان	Ncs
مکانهای	مکان	Ncl
مکانی	مکان	Ncs
مکانیسم	مکانیسم	Ncs
مکانیسمهای	مکانیسم	Ncl
مکتب	مکتب	Ncs
مکتبهای	مکتب	Ncl
مکرر	مکرر	As
مکشوفه	مکشوفه	As
مکلف	مکلف	As
مکمل	مکمل	As
مکملهای	مکمل	Ncl
مکه	مکه	Nas
مگر	مگر	Dg
ملاحظه	ملاحظه	Ncs
ملاقات	ملاقات	Ncs
ملاک	ملاک	Ncs
ملت	ملت	Ncs
ملتها	ملت	Ncl
ملک	ملک	Ncs
ملکی	ملک	Ncs
ملل	ملت	Ncl
ملموس	ملموس	As
ملوس	ملوس	Nas
ملی	ملی	As
ملینا	ملینا	Nas
ممتاز	ممتاز	As
ممر	ممر	Ncs
ممکن	ممکن	As
مملکت	مملکت	Ncs
ممیز	ممیز	Nas
منابع	منبع	Ncl
منابعی	منبع	Ncl
منادی	منادی	Ncs
مناسب	مناسب	As
مناسبات	مناسبت	Ncl
مناسبت	مناسبت	Ncs
مناسبترین	مناسب	Au
مناسبی	مناسب	As
مناسک	منسک	Ncl
مناطق	منطقه	Ncl
مناظر	منظره	Ncl
منافع	منفعت	Ncl
منان	منان	As
منبر	منبر	Ncs
منبع	منبع	Ncs
منتسب	منتسب	As
منتشر	منتشر	As
منتشرشده	منتشرشده	As
منتشره	منتشره	As
منتقد	منتقد	As
منتقل	منتقل	As
منتهی	منتهی	Dg
منجر	منجر	As
منحرف	منحرف	As
منحل	منحل	As
منزل	منزل	Ncs
منزلت	منزلت	Ncs
منزله	منزله	Ncs
منسوخ	منسوخ	As
منشیهای	منشی	Ncl
منصفانه	منصفانه	As
منصفه	منصفه	As
منصوب	منصوب	As
منطبق	منطبق	As
منطق	منطق	Ncs
منطقه	منطقه	Ncs
منطقی	منطقی	As
منظم	منظم	As
منظور	منظور	Ncs
منعکس	منعکس	As
منفجره	منفجره	As
منفور	منفور	As
منوچ	منوچ	Nas
منوط	منوط	As
منهای	منها	Ncs
مواجه	مواجه	As
مواجهه	مواجهه	Ncs
مواد	ماده	Ncl
موادی	ماده	Ncl
موارد	مورد	Ncl
موارد	مورد	Ncl
مواردی	مورد	Ncl
مواضع	موضع	Ncl
موافق	موافق	As
موافق	موافق	Ncs
موافقت	موافقت	Ncs
موافقتنامه	موافقتنامه	Ncs
مواقع	موقع	Ncl
موانع	مانع	Ncl
موتیلیتی	موتیلیتی	Ncs
موثر	موثر	As
موثق	موثق	As
موج	موج	Ncs
موجب	موجب	Ncs
موجود	موجود	As
موجود	موجود	Ncs
موجودات	موجود	Ncl
موحدی	موحدی	Nas
مورد	مورد	Ls
مورد	مورد	Ncs
موردی	مورد	Ncs
مورسیای	مورسیای	Nas
موز	موز	Ncs
موزه	موزه	Ncs
موسسه	موسسه	Ncs
موسوم	موسوم	As
موسوی	موسوی	Nas
موسی	موسی	Nas
موسیقی	موسیقی	Ncs
موسیقیهای	موسیقی	Ncl
موضع	موضع	Ncs
موضعگیری	موضعگیری	Ncs
موضوع	موضوع	Ncs
موضوعات	موضوع	Ncl
موضوعاتی	موضوع	Ncl
موعد	موعد	Ncs
موعظه	موعظه	Ncs
موفق	موفق	As
موفقیت	موفقیت	Ncs
موفقیتی	موفقیت	Ncs
موقت	موقت	As
موقعیت	موقعیت	Ncs
موقعیتها	موقعیت	Ncl
موقوفه	موقوفه	As
مولانا	مولانا	Nas
مولای	مولا	Ncs
موهای	مو	Ncl
موهوم	موهوم	As
مهاجرانی	مهاجرانی	Nas
مهاجرت	مهاجرت	Ncs
مهار	مهار	Ncs
مهارت	مهارت	Ncs
مهر	مهر	Nas
مهر	مهر	Ncs
مهرها	مهر	Ncl
مهرهای	مهر	Ncl
مهلت	مهلت	Ncs
مهم	مهم	As
مهم	مهم	Ncs
مهمانی	مهمانی	Ncs
مهمتر	مهم	Ac
مهمترین	مهم	Au
مهمی	مهم	As
مهمی	مهمی	Ncs
مهندس	مهندس	Nas
مهندسین	مهندس	Ncl
مؤتلفه	مؤتلفه	Nas
مؤثر	مؤثر	As
مؤثرتر	مؤثر	Ac
مؤثری	مؤثر	As
مؤسسه	مؤسسه	Ncs
مؤمن	مؤمن	As
میان	میان	Ez
میان	میان	Ncs
میانبر	میانبر	As
میدان	میدان	Ncs
میدهد	دادن,ده,داد	Vpy
میر	میر	Nas
میراث	میراث	Ncs
میرزا	میرزا	Nas
میز	میز	Ncs
میزان	میزان	Ls
میزان	میزان	Ncs
میزبان	میزبان	Ncs
میشل	میشل	Nas
میکائیلی	میکائیلی	Nas
میگرن	میگرن	Ncs
میگرنی	میگرنی	As
میل	میل	Ncs
میلاد	میلاد	Ncs
میلادی	میلادی	As
میلیارد	میلیارد	Ur
میلیون	میلیون	Ur
میهمان	میهمان	Ncs
میهمانی	میهمانی	Ncs
ناباب	ناباب	As
نابسامانیهای	نابسامانی	Ncl
نابود	نابود	As
نابودی	نابودی	Ncs
ناپدید	ناپدید	As
ناتوان	ناتوان	As
ناحیه	ناحیه	Ncs
ناخشنود	ناخشنود	As
ناخواسته	ناخواسته	As
نادرست	نادرست	As
نادمان	نادم	Ncl
نادیده	نادیده	As
ناراحتی	ناراحتی	Ncs
نارس	نارس	As
نارسایی	نارسایی	Ncs
نارسائی	نارسائی	Ncs
نازک	نازک	As
ناسا	ناسا	Nas
ناسزا	ناسزا	Ncs
ناشایست	ناشایست	As
ناشناخته	ناشناخته	As
ناشناس	ناشناس	As
ناشی	ناشی	As
ناظر	ناظر	As
نافرجام	نافرجام	As
ناکام	ناکام	As
ناکام	ناکام	Dg
ناگهان	ناگهان	Dg
ناگهانی	ناگهانی	As
نام	نام	Ncs
نامالوف	نامالوف	As
نامداری	نامدار	As
نامربوط	نامربوط	As
نامردمی	نامردمی	Ncs
نامرئی	نامرئی	As
نامطلوب	نامطلوب	As
نامناسب	نامناسب	As
ناموفق	ناموفق	As
ناموفق	ناموفق	Dg
نامه	نامه	Ncs
نامهای	نام	Ncl
نامی	نام	Ncs
نامیدن	نامیدن,نام,نامید	Vp-
نانها	نان	Ncl
ناهار	ناهار	Ncs
ناهنجاری	ناهنجاری	Ncs
نایب	نایب	Ncs
نباتی	نباتی	As
نباشد	بودن,باش,بود	Vny
نباشند	بودن,باش,بود	Vny
نباشید	بودن,باش,بود	Vny
نباشیم	بودن,باش,بود	Vny
نباید	باید,باید,باید	Vnx
نبندد	بستن,بند,بست	Vny
نبود	بودن,باش,بود	Vny
نبودند	بودن,باش,بود	Vny
نبوغ	نبوغ	Ncs
نبوی	نبوی	Nas
نبی	نبی	Nas
نپردازد	پرداختن,پرداز,پرداخت	Vny
نتایج	نتیجه	Ncl
نتایجی	نتیجه	Ncl
نتیجه	نتیجه	Ncs
نجات	نجات	Ncs
نجف	نجف	Nas
نحو	نحو	Ncs
نحوه	نحوه	Ncs
نحوی	نحو	Ncs
نخست	نخست	Dg
نخست	نخست	Uo
نخستین	نخستین	Uo
نخلستان	نخلستان	Ncs
نخواند	خواندن,خوان,خواند	Vny
نخواهد	خواستن,خواه,خواست	Vnx
نخواهند	خواستن,خواه,خواست	Vnx
نخود	نخود	Ncs
نخیله	نخیله	Nas
نداده	دادن,ده,داد	Vn-
ندارد	داشتن,دار,داشت	Vny
ندارند	داشتن,دار,داشت	Vny
نداریم	داشتن,دار,داشت	Vny
نداشت	داشتن,دار,داشت	Vny
نداشتن	داشتن,دار,داشت	Vn-
نداشتند	داشتن,دار,داشت	Vny
نداشته	داشتن,دار,داشت	Vn-
نداند	دانستن,دان,دانست	Vny
نرخ	نرخ	Ncs
نرسید	رسیدن,رس,رسید	Vny
نرمش	نرمش	Ncs
نزد	نزد	Ez
نزد	نزد	Ncs
نزدیک	نزدیک	As
نزدیک	نزدیک	Ncs
نزدیکی	نزدیک	As
نزدیکی	نزدیکی	Ncs
نژاد	نژاد	Ncs
نسبت	نسبت	Ncs
نسل	نسل	Ncs
نسوان	نسوان	Nas
نسیم	نسیم	Ncs
نشاط	نشاط	Ncs
نشاطی	نشاط	Ncs
نشان	نشان	Ncs
نشانگر	نشانگر	Ncs
نشانه	نشانه	Ncs
نشت	نشت	Ncs
نشد	شدن,شو,شد	Vny
نشدند	شدن,شو,شد	Vny
نشده	شدن,شو,شد	Vn-
نشر	نشر	Ncs
نشریات	نشریه	Ncl
نشریه	نشریه	Ncs
نشست	نشست	Ncs
نشستند	نشستن,نشین,نشست	Vpy
نشستی	نشست	Ncs
نشود	شدن,شو,شد	Vny
نشوند	شدن,شو,شد	Vny
نشویل	نشویل	Nas
نصب	نصب	Ncs
نصرالمؤمنین	نصرالمؤمنین	Rw
نصرت	نصرت	Ncs
نصرتهای	نصرت	Ncl
نصف	نصف	Uo
نصیبی	نصیب	Ncs
نطق	نطق	Ncs
نطنز	نطنز	Nas
نظارت	نظارت	Ncs
نظام	نظام	Ncs
نظامی	نظام	Ncs
نظامی	نظامی	As
نظر	نظر	Ncs
نظرات	نظر	Ncl
نظرسنجی	نظرسنجی	Ncs
نظرسنجیهای	نظرسنجی	Ncl
نظری	نظر	Ncs
نظریات	نظریه	Ncl
نظریه	نظریه	Ncs
نظیر	نظیر	Dg
نعمت	نعمت	Ncs
نفاق	نفاق	Ncs
نفت	نفت	Ncs
نفتی	نفتی	As
نفر	نفر	Ls
نفر	نفر	Ncs
نفرات	نفر	Ncl
نفع	نفع	Ncs
نفوذ	نفوذ	Ncs
نفوذی	نفوذی	Ncs
نفوذیها	نفوذی	Ncl
نفی	نفی	Ncs
نقاش	نقاش	Ncs
نقاشی	نقاشی	Ncs
نقاط	نقطه	Ncl
نقد	نقد	As
نقد	نقد	Ncs
نقرس	نقرس	Ncs
نقره	نقره	Ncs
نقش	نقش	Ncs
نقشه	نقشه	Ncs
نقشهای	نقش	Ncl
نقشی	نقش	Ncs
نقص	نقص	Ncs
نقطه	نقطه	Ncs
نقل	نقل	Ncs
نکات	نکته	Ncl
نکته	نکته	Ncs
نکرد	کردن,کن,کرد	Vny
نکردند	کردن,کن,کرد	Vny
نکرده	کردن,کن,کرد	Vn-
نکند	کردن,کن,کرد	Vny
نکنند	کردن,کن,کرد	Vny
نگارش	نگارش	Ncs
نگارنده	نگارنده	Ncs
نگاه	نگاه	Ncs
نگاهداری	نگاهداری	Ncs
نگاهی	نگاه	Ncs
نگذارید	گذاشتن,گذار,گذاشت	Vny
نگران	نگران	As
نگرانیها	نگرانی	Ncl
نگردند	گردیدن,گرد,گردید	Vny
نگرش	نگرش	Ncs
نگرشها	نگرش	Ncl
نگرشهای	نگرش	Ncl
نگه	نگه	Ncs
نگهبان	نگهبان	Ncs
نگهداری	نگهداری	Ncs
نگینی	نگینی	As
نمادها	نماد	Ncl
نماز	نماز	Ncs
نماند	ماندن,مان,ماند	Vny
نمای	نما	Ncs
نمایان	نمایان	As
نمایاندن	نمایاندن,نمایان,نمایاند	Vp-
نماید	نمودن,نما,نمود	Vpy
نمایش	نمایش	Ncs
نمایشگاه	نمایشگاه	Ncs
نمایشگاهها	نمایشگاه	Ncl
نمایشی	نمایشی	As
نمایند	نمودن,نما,نمود	Vpy
نمایندگان	نماینده	Ncl
نمایندگی	نمایندگی	Ncs
نماینده	نماینده	Ncs
نماییم	نمودن,نما,نمود	Vpy
نمدین	نمدین	As
نمک	نمک	Ncs
نمناک	نمناک	As
نمود	نمودن,نما,نمود	Vpy
نمودن	نمودن,نما,نمود	Vp-
نموده	نمودن,نما,نمود	Vp-
نمونه	نمونه	Ncs
ننگ	ننگ	Ncs
نوار	نوار	Ncs
نوارهای	نوار	Ncl
نوازندگان	نوازنده	Ncl
نوآوری	نوآوری	Ncs
نوجوانان	نوجوان	Ncl
نور	نور	Ncs
نورا	نورا	Nas
نورنبرگ	نورنبرگ	Nas
نوری	نور	Ncs
نوزاد	نوزاد	Ncs
نوزادان	نوزاد	Ncl
نوزادانی	نوزاد	Ncl
نوزادی	نوزادی	Ncs
نوشت	نوشتن,نویس,نوشت	Vpy
نوشتار	نوشتار	Ncs
نوشتن	نوشتن,نویس,نوشت	Vp-
نوشهر	نوشهر	Nas
نوع	نوع	Ls
نوع	نوع	Ncs
نوعی	نوع	Ncs
نوقه	نوقه	Nas
نوک	نوک	Ncs
نوکران	نوکر	Ncl
نویسندگان	نویسنده	Ncl
نویسنده	نویسنده	Ncs
نهاد	نهاد	Ncs
نهاد	نهادن,نه,نهاد	Vpy
نهادند	نهادن,نه,نهاد	Vpy
نهاده	نهادن,نه,نهاد	Vp-
نهادها	نهاد	Ncl
نهادهای	نهاد	Ncl
نهایت	نهایت	Ncs
نهایی	نهایی	As
نهضت	نهضت	Ncs
نهند	نهادن,نه,نهاد	Vpy
نیابد	یافتن,یاب,یافت	Vny
نیات	نیت	Ncl
نیاز	نیاز	Ncs
نیازمند	نیازمند	As
نیازهای	نیاز	Ncl
نیازی	نیاز	Ncs
نیاکانی	نیاکانی	As
نیایشی	نیایشی	As
نیروها	نیرو	Ncl
نیروهای	نیرو	Ncl
نیروی	نیرو	Ncs
نیری	نیری	Nas
نیز	نیز	J-
نیزه	نیزه	Ncs
نیست	هستن,نیست,بود	Vny
نیست	هستن,نیست,بود	Vny
نیستم	هستن,نیست,بود	Vny
نیستند	هستن,نیست,بود	Vny
نیستی	نیستی	Ncs
نیشکر	نیشکر	Ncs
نیکوکار	نیکوکار	As
نیکوکاران	نیکوکار	Ncl
نیم	نیم	Ur
نیمه	نیمه	Ncs
نیمی	نیم	Ur
نیومکزیکو	نیومکزیکو	Nas
نیویورک	نیویورک	Nas
وابسته	وابسته	As
واتل	واتل	Nas
واجپایی	واجپایی	Nas
واحد	واحد	Ls
واحد	واحد	Ncs
واحده	واحده	As
واحدها	واحد	Ncl
واحدهای	واحد	Ncl
واحدی	واحد	As
وارد	وارد	Ez
وارد	وارد	Ncs
وارداتی	وارداتی	As
واژه	واژه	Ncs
واسطه	واسطه	Ncs
واشنگتن	واشنگتن	Nas
واضح	واضح	As
واضحی	واضح	As
واقع	واقع	As
واقع	واقع	Ncs
واقعا	واقعا	Dg
واقعی	واقعی	As
واقعیات	واقعیت	Ncl
واقعیت	واقعیت	Ncs
واقعیتهای	واقعیت	Ncl
واقعیتی	واقعیت	Ncs
واقف	واقف	As
واکسن	واکسن	Ncs
واکسنی	واکسن	Ncs
واکنش	واکنش	Ncs
واکنشهای	واکنش	Ncl
واکنشهایی	واکنش	Ncl
واکنشی	واکنش	Ncs
واگذار	واگذار	As
واگذاری	واگذاری	Ncs
واگیردار	واگیردار	As
والتر	والتر	Nas
والدین	والد	Ncl
والی	والی	Ncs
وام	وام	Ncs
وانمود	وانمود	As
واهی	واهی	As
وجود	وجود	Ncs
وجه	وجه	Ncs
وجهه	وجهه	Ncs
وحدت	وحدت	Ncs
وحشت	وحشت	Ncs
وحشتناک	وحشتناک	As
وحید	وحید	Nas
ورزش	ورزش	Ncs
ورزشگاه	ورزشگاه	Ncs
ورزشی	ورزشی	As
ورق	ورق	Ncs
ورم	ورم	Ncs
ورمیتک	ورمیتک	Nas
ورود	ورود	Ncs
وزارت	وزارت	Ncs
وزارتخانه	وزارتخانه	Ncs
وزرا	وزیر	Ncl
وزش	وزش	Ncs
وزن	وزن	Ncs
وزنهای	وزن	Ncl
وزوز	وزوز	Ncs
وزیر	وزیر	Ncs
وسایل	وسیله	Ncl
وسط	وسط	Ncs
وسطی	وسطی	As
وسکی	وسکی	Nas
وسیع	وسیع	As
وسیعی	وسیع	As
وسیله	وسیله	Ncs
وضع	وضع	Ncs
وضعیت	وضعیت	Ncs
وضعیتهای	وضعیت	Ncl
وظایف	وظیفه	Ncl
وظیفه	وظیفه	Ncs
وعاظ	واعظ	Ncl
وعده	وعده	Ncs
وقار	وقار	Ncs
وقت	وقت	Ncs
وقتی	وقت	Ncs
وقتی	وقتی	J-
وقف	وقف	Ncs
ولت	ولت	Ncs
ولی	ولی	J-
ولید	ولید	Nas
ونزوئلا	ونزوئلا	Nas
ونزوئلائی	ونزوئلا	As
ونسان	ونسان	Nas
ونگوگ	ونگوگ	Nas
وود	وود	Nas
وومرای	وومرای	Nas
وهله	وهله	Ncs
ویتامینها	ویتامین	Ncl
ویتدال	ویتدال	Nas
ویتنام	ویتنام	Nas
ویدئو	ویدئو	Ncs
ویران	ویران	As
ویرجینیای	ویرجینیای	Nas
ویروس	ویروس	Ncs
ویروسهای	ویروس	Ncl
ویروسی	ویروسی	As
ویزای	ویزا	Ncs
ویژگیهای	ویژگی	Ncl
ویژگیهایی	ویژگی	Ncl
ویژه	ویژه	As
ویلای	ویلا	Ncs
ویلیام	ویلیام	Nas
هادن	هادن	Nas
هارا	هارا	Nas
هارش	هارش	Nas
هالدنی	هالدنی	Nas
هجمه	هجمه	Ncs
هجوم	هجوم	Ncs
هخامنشی	هخامنشی	Nas
هخامنشیان	هخامنشیان	Nal
هدایایی	هدیه	Ncl
هدر	هدر	Ncs
هدف	هدف	Ncs
هدفمندتر	هدفمند	Ac
هدیه	هدیه	Ncs
هربرت	هربرت	Nas
هرچند	هرچند	J-
هرچندکه	هرچندکه	J-
هرچه	هرچه	Di
هرسین	هرسین	Nas
هرگز	هرگز	Dg
هروئین	هروئین	Ncs
هزار	هزار	Ur
هزاران	هزاران	Ur
هزاره	هزاره	Ncs
هزینه	هزینه	Ncs
هست	هستن,هست,بود	Vpy
هستند	هستن,هست,بود	Vpy
هستند	هستن,هست,بود	Vpy
هستید	هستن,هست,بود	Vpy
هستیم	هستن,هست,بود	Vpy
هشت	هشت	Ur
هشتاد	هشتاد	Ur
هشدار	هشدار	Ncs
هشداردهنده	هشداردهنده	As
هشیاری	هشیاری	Ncs
هضم	هضم	Ncs
هفت	هفت	Ur
هفتاد	هفتاد	Ur
هفتم	هفتم	Uo
هفته	هفته	Ncs
همان	همان	Tm
همانند	همانند	Dg
هماهنگ	هماهنگ	As
همت	همت	Ncs
همچنان	همچنان	Dg
همچنین	همچنین	J-
همچون	همچون	Dg
همخوانی	همخوانی	Ncs
همدلی	همدلی	Ncs
همراه	همراه	As
همراه	همراه	Ncs
همراهی	همراهی	Ncs
همزمان	همزمان	As
همزمان	همزمان	Dg
همسانی	همسانی	Ncs
همسر	همسر	Ncs
همشهری	همشهری	Nas
همفکران	همفکر	Ncl
همفکری	همفکری	Ncs
همکاری	همکاری	Ncs
همکاریهای	همکاری	Ncl
همگام	همگام	As
همگان	همگان	Zfl
همگانی	همگانی	As
همگرایی	همگرایی	Ncs
همگروه	همگروه	As
همگی	همگی	Zfs
هموار	هموار	As
همواره	همواره	Dg
هموطنان	هموطن	Ncl
همه	همه	Tf
همه	همه	Zfs
همیشه	همیشه	Dg
همین	همین	Tm
هند	هند	Nas
هنر	هنر	Ncs
هنرپیشه	هنرپیشه	Ncs
هنرمند	هنرمند	Ncs
هنرمندان	هنرمند	Ncl
هنرمندانی	هنرمند	Ncl
هنرمندی	هنرمند	Ncs
هنرهای	هنر	Ncl
هنری	هنر	Ncs
هنری	هنری	As
هنگام	هنگام	Ncs
هنگامه	هنگامه	Ncs
هنوز	هنوز	Dg
هوا	هوا	Nas
هوا	هوا	Ncs
هواپیما	هواپیما	Ncs
هواپیمای	هواپیما	Ncs
هوادار	هوادار	As
هوانوردی	هوانوردی	Ncs
هوای	هوا	Ncs
هورس	هورس	Nas
هورمونهای	هورمون	Ncl
هوشیاری	هوشیاری	Ncs
هوور	هوور	Nas
هویت	هویت	Ncs
هویج	هویج	Ncs
هیات	هیات	Ncs
هیأت	هیأت	Ncs
هیپوکلسمی	هیپوکلسمی	Ncs
هیجان	هیجان	Ncs
هیچ	هیچ	Tf
هیچگاه	هیچگاه	Dg
هیئت	هیئت	Ncs
هیئتهای	هیئت	Ncl
یابد	یافتن,یاب,یافت	Vpy
یابند	یافتن,یاب,یافت	Vpy
یابیم	یافتن,یاب,یافت	Vpy
یاد	یاد	Ncs
یادآور	یادآور	As
یادآوری	یادآوری	Ncs
یادداشت	یادداشت	Ncs
یادداشتهای	یادداشت	Ncl
یادداشتی	یادداشت	Ncs
یادشده	یادشده	As
یادگار	یادگار	Ncs
یاران	یار	Ncl
یاری	یاری	Ncs
یازدهمین	یازدهمین	Uo
یافت	یافت	Ncs
یافت	یافتن,یاب,یافت	Vpy
یافتم	یافتن,یاب,یافت	Vpy
یافتن	یافتن,یاب,یافت	Vp-
یافتند	یافتن,یاب,یافت	Vpy
یافته	یافتن,یاب,یافت	Vp-
یائسگی	یائسگی	Ncs
یائسه	یائسه	As
یتان	یتان	Ce
یشان	یشان	Ce
یشم	یشم	Ncs
یعنی	یعنی	Dg
یعنی	یعنی	J-
یعنی	یعنی	Vpy
یقین	یقین	Ncs
یکدیگر	یکدیگر	Zc-
یکساله	یکساله	As
یکسویه	یکسویه	As
یکشنبه	یکشنبه	Nas
یکه	یکه	As
یکه	یکه	Ncs
یکی	یکی	As
یکی	یکی	Ur
یمان	یمان	Ce
یمنی	یمنی	As
یند	یند	Ce
یورو	یورو	Nas
یونان	یونان	Nas
یونانی	یونانی	As
یونانیها	یونان	Nal
یهودیان	یهودی	Nal
